magnetic	[mægˈnetɪk] a. 磁的，有磁性的；有吸引力的
long-term	[lɒŋ tɜ:m] a. 长期的
mentor	[ˈmentɔː(r)] n. 导师；顾问，指导者
autobiography	[ˏɔːtəbaɪˈɔgrəfɪ] n. 自传
conceptual	[kənˈseptʃuəl] a. 观念的，概念的
liver	[ˈlɪvə(r)] n. 生活者，居住者；肝脏
recession	[rɪˈseʃn] n. （经济的）衰退，衰退时期；撤回，退回
organism	[ˈɔːgənɪzəm] n. 生物；有机体
enslave	[ɪnˈsleɪv] vt. 奴役，征服，使受控制
wrinkle	|
neutral	[ˈnjuːtrəl] a. 中立的；无明显特性的
disorientate	[dɪsˈɔːrɪənteɪt] vt. 使失去方向感；使迷茫，使不知所措（= disorient）
weed	[wiːd] n. 杂草
solidify	[səˈlɪdɪfaɪ] v. 巩固，确保；凝固，（使）固化；团结
scorching	[ˈskɔ:tʃɪŋ] a. 酷热的；激烈的
sharpen	['ʃɑ:pən] v. 削尖，磨快；使敏锐，使敏捷
extinguish	[ɪkˈstɪŋgwɪʃ] vt. 熄灭，扑灭；消灭，使破灭
frame	|
disappointing	[ˌdɪsəˈpɔɪntɪŋ] a. 令人失望的
herbal	|
archive	|
manipulate	[məˈnɪpjuleɪt] vt. 应付，处理；操纵，控制；影响
notify	[ˈnəutɪfaɪ] vt. 通知，报告
proclaim	[prəˈkleɪm] v. 宣告，宣布，声明；显示
terrify	[ˈterɪfaɪ] vt. 使恐怖，使惊吓
principle	[ˈprɪnsəpl] n. 原则，原理；规范，准则；基本信念，信条
caution	|
circumscribe	[ˈsɜːkəmskraɪb] vt. 在……周围画线；限制
shallow	[ˈʃæləu] a. 浅的；肤浅的，浅薄的
motivational	[ˌməʊtɪ'veɪʃənl] a. 动机的，有关动机的
balcony	[ˈbælkənɪ] n. 阳台；楼座
finale	[fɪˈnɑːlɪ] n. （音乐的）终曲；终场
rim	[rɪm] n. （圆形物体的）边，缘
subsequent	[ˈsʌbsɪkwənt] a. 继……之后的，随后的
dormitory	[ˈdɔːmɪtrɪ] n. （集体）宿舍
assist	[əˈsɪst] v. 帮助，援助，协助
estimate	|
approximately	[əˈprɒksɪmətli] ad. 近似，大约
magnify	[ˈmægnɪfaɪ] vt. 放大，扩大
fact-sheet	__fact__ __sheet__ [fækt ʃi:t] n. （尤指英国广播或电视节目中有关讨论题目的）资料页
structure	|
procrastinate	__proscrastinate__ [prəuˈkræstɪneɪt] v. 耽搁，拖延
caustic	|
diminish	[dɪˈmɪnɪʃ] v. 减少；降低；贬低，轻视
fulfil	[fulˈfɪl] vt. 实现，完成；满足
embed	[ɪmˈbed] vt. 把……嵌入（或埋入、插入），扎牢；使深留脑中
load	|
libel	|
convenience	[kənˈviːnɪəns] n. 方便；便利设施
diploma	[dɪˈpləumə] n. 毕业文凭（或证书）；资格证书
sufficient	[səˈfɪʃnt] a. 足够的，充分的
inhibit	[ɪnˈhɪbɪt] v. 抑制，约束；起抑制作用
depression	[dɪˈpreʃn] n. 忧愁，消沉；低气压，低压；不景气，萧条（期）
ascertain	[ˏæsəˈteɪn] vt. 弄清，查明；确定
generic	[dʒɪˈnerɪk] a. 一般的，普通的，通用的；种的，属的
ultimately	[ˈʌltɪmətli] ad. 最终地
clarify	[ˈklærɪfaɪ] vt. 澄清；阐明
consortium	[kənˈsɔːtɪəm] n. 集团；财团；社团，协会
browse	|
betray	[bɪˈtreɪ] vt. 出卖，泄露（秘密等）；辜负；流露情感
rehabilitate	[ˏriːəˈbɪlɪteɪt] vt. 改造（罪犯等），使恢复正常生活；使恢复原状，修复；复职；恢复……的名誉
skyscraper	['skaɪskreɪpə(r)] n. 摩天楼
bulge	[bʌldʒ] n./v. 膨胀；凸出；塞满
formulation	[ˌfɔ:mjʊ'leɪʃn] n. 公式化，格式化；确切的表达
dense	[dens] a. 密集的；浓厚的
synthetic	[sɪnˈθetɪk] a. 人造的；合成的，综合的  n. 合成物；合成纤维（织物）
sucker	[ˈsʌkə(r)] n. 吸盘；吸根，根出条
nerve	[nɜːv] n. 神经；勇敢
buckle	|
district	[ˈdɪstrɪkt] n. 区，地区
aerospace	[ˈeərəuspeɪs] n. 宇宙空间；航空航天技术
comic	|
punch	|
volt	[vəult] n. 伏特
foil	[fɔɪl] n. 箔；箔纸
marketplace	[ˈmɑ:kɪtpleɪs] n. 市场，集市
invisible	[ɪnˈvɪzəbl] a. 看不见的，无形的
widespread	__wildspread__ [ˈwaɪdspred] a. 分布广的；普遍的
daunt	[dɔːnt] vt. 使气馁，使胆怯
confront	[kənˈfrʌnt] vt. 遭遇；面对，正视
interior	|
dorm	[dɔːm] n. 宿舍
synchronise	[ˈsɪŋkrənaɪz] v. （使）同步发生，同速进行
spoil	|
settle	[ˈsetl] v. 定居，安家；解决，调停；安排，安放；支付，结算；安置于；（鸟等）飞落，停留，栖息
plush	|
expand	[ɪkˈspænd] v. （使）膨胀，（使）扩张；张开，展开；详述
extra	|
variety	[vəˈraɪətɪ]  n. 品种，种类；变化，多样化
enthusiastic	__enthusiasitc__ [ɪnˌθju:ziˈæstɪk] a. 热情的；热心的
prototype	[ˈprəutətaɪp] n. 原型，蓝本
religion	__religeion__ [rɪˈlɪdʒən] n. 宗教；宗教信仰
verify	[ˈverɪfaɪ] vt. 证明；证实
nurture	|
jealous	[ˈdʒeləs] a. 嫉妒的；猜疑的
due	[djuː] a. 到期的，预期的；应有的，应得的；正当的
beneficial	__benificial__ [ˏbenɪˈfɪʃl] a. 有利的，有益的
unbeatable	[ˏʌnˈbiːtəbl] a. 无敌的，不可战胜的
comment	|
tenant	[ˈtenənt] n. 承租人；房客；佃户
spine	[spaɪn] n. 脊椎，脊柱；（动植物的）刺，刺毛；书脊；<喻> 中心
emperor	[ˈempərə(r)] n. 皇帝；君主
leap	|
courtship	[ˈkɔːt-ʃɪp] n. 求爱或追求；求爱期，追求期
participation	[pɑ:ˌtɪsɪˈpeɪʃn] n. 分享；参与
unexpected	[ʌnɪkˈspektɪd] a. 想不到的，意外的
mainly	[ˈmeɪnli] ad. 大体上，主要地
pudding	[ˈpudɪŋ] n. 布丁
arrangement	[əˈreɪndʒmənt] n. 安排； [常pl.] 准备工作
domesticate	[dəˈmestɪkeɪt] vt. 驯养，教化；使喜爱家居生活
harness	|
particularly	[pəˈtikjuləli] ad. 特别，尤其
vacuum	|
jumble	|
scuffle	[ˈskʌfl] n./vi. 扭打，混战
spin	|
spare	|
outlaw	|
utilization	__utilizatioin__ [ˌju:təlaɪ'zeɪʃn] n. 利用
augment	[ɔːgˈment] vt. 增加，提高，扩大
inlet	[ˈɪnlet] n. 入口；进（水）口，水湾
orientation	[ˌɔ:riənˈteɪʃn] n. 定位；方向，方位；情况介绍；培训，训练
remind	[rɪˈmaɪnd] vt. 提醒，使想起；使发生联想
abundance	[əˈbʌndəns] n. 大量，丰富，充足，充裕
liberty	[ˈlɪbətɪ] n. 自由，自由权；许可，准许  [常pl.] 过于随便，放肆
fitting	|
photocopy	|
ambitious	[æmˈbɪʃəs] a. 有抱负的，有雄心的，有野心的
fold	|
sustainable	[səˈsteɪnəbl] a. 可以忍受的；足以支撑的；养得起的
momentum	[məˈmentəm] n. 动力，冲力，势头；动量
channel	[ˈtʃænl] n. 频道； [常pl.] 渠道，途径；沟渠；海峡，水道；航道
endure	[ɪnˈdjuə(r)] v. 忍受；持久，持续
pirate	|
impoverished	___impoverished_ [ɪmˈpɒvərɪʃt] a. 穷困的，赤贫的；贫乏的，贫瘠的；枯竭的
confidence	[ˈkɔnfɪdəns] n. 信任；信心
symbolism	[ˈsɪmbəlɪzəm] n. 符号的使用；（尤指文艺中的）象征主义，象征手法
grudge	|
tighten	['taɪtn] v. （使）变紧；使更加严格，加强
coexist	[ˏkəuɪgˈzɪst] vi. 共存
log	|
diversify	[daɪˈvɜːsɪfaɪ] v. （使）多样化
stock	|
terrace	__terrace_ [ˈterəs] n. 一层梯田；一排并列的房子；阳台
condemn	[kənˈdem] vt. 声讨，极力谴责；给……判刑
session	[ˈseʃn] n. 一场，一节；会议；集会
accessible	[əkˈsesəbl] a. 能接近的；易达到的
victim	[ˈvɪktɪm] n. 牺牲者；受害者
fragrance	[ˈfreɪgrəns] n. 芳香，香味；香水
questionnaire	[ˏkwestʃəˈneə(r)] n. 问卷，调查表
extendable	[ɪkˈstendəbl] a. 可延伸的，可展开的，可扩张的
wretch	[retʃ] n. 不幸的人
toxic	[ˈtɔksɪk] a. 有毒的；中毒的
frontier	[ˈfrʌntɪə(r)] n. 边境，边界；开发地区的边缘地带；[常pl.] 前沿，新领域
energetic	[ˌenəˈdʒetɪk] a. 有力的，精力旺盛的；积极的
release	|
occupation	[ˏɔkjuˈpeɪʃn] n. 占领；职业；消遣
stringent	[ˈstrɪndʒənt] a. （法律、规则等）严格的，苛刻的；（财政状况）紧缩的，短缺的，银根紧的；迫切的
course	|
economical	[ˏiːkəˈnɔmɪkl] a. 节约的；经济的
vested	['vestɪd] a. 法律规定的；既定的
enlist	[ɪnˈlɪst] v. 征募；从军，参军；谋取（帮助，支持等）
sprawl	|
dioxide	[daɪˈɔksaɪd] n. 二氧化物
tutorial	|
emotion	[ɪˈməuʃn] n. 感情；情绪
mental	[ˈmentl] a. 心理的，精神的；智力的
behalf	[bɪˈhɑːf] n. 利益；代表
supervision	[ˌsu:pə'vɪʒn]; [ˌsju:pə'vɪʒn] n. 监督，管理；指导
begrimed	[bɪ'graɪmd] a. 污秽的
evolution	[ˏiːvəˈluːʃn] n. 进展；进化
glacier	__gracier__ [ˈglæsɪə(r)] n. 冰川，冰河
administrator	[ədˈmɪnɪstreɪtə(r)] n. 管理者，管理人员；行政人员
swear	[sweə(r)] v. 宣（誓）；诅咒
regurgitate	[rɪˈgɜːdʒɪteɪt] vt. 涌回，流回；[动] （使）反胃，将（咽下的食物）返回到口中，反刍
cooperation	[kəuˏɔpəˈreɪʃn] n. 合作，协作；配合
incur	[ɪnˈkɜː(r)] vt. 招致，遭受
disturbance	[dɪˈstɜːbəns] n. 扰乱，打扰；骚乱，混乱；心神不安，烦恼
neglect	[nɪˈglekt] n./vt. 忽视；疏忽；遗漏
livelihood	[ˈlaɪvlɪhud] n. 生活，生计
dormancy	['dɔ:mənsɪ] n. 休眠；催眠状态；冬眠；隐匿
clue	[kluː] n. 线索；提示
aerobics	[eəˈrəubɪks] n. 有氧运动
venture	|
topsoil	[ˈtɒpsɔɪl] n. 表层土
bargain	|
vice-versa	__vice__ __versa__ [ˏvaɪsɪ ˈvɜːsə] 反之亦然
professional	|
commence	[kəˈmens] v. 开始，着手
stylish	[ˈstaɪlɪʃ] a. 时髦的；漂亮的
identity	[aɪˈdentətɪ] n. 身份；特性；同一性
combustion	[kəmˈbʌstʃən] n. 燃烧；燃烧过程
alter	[ˈɔːltə(r)] vt. 改变；变动
wedge	|
continuity	[ˏkɔntɪˈnjuːətɪ] n. 连续（性）；持续（性）
spice	|
transmit	[træns'mɪt] v. 传送；传染；发射
entertainment	[ˌentəˈteɪnmənt] n. 招待，款待；娱乐（业）；供消遣的事物
argue	[ˈɑːgjuː] v. 争论；说服
substantial	[səbˈstænʃl] a. 可观的，大量的；坚固的，结实的；实质的；大体上的
curry	|
compliment	[ˈkɔmplɪmənt] n. 赞美；[pl.] 问候，祝贺
ambiguous	[æmˈbɪgjuəs] a. 含糊其辞的； 不明确的，模棱两可的
biased	[ˈbaɪəst] a. 有偏见的；片面的
approve	[əˈpruːv] v. 赞成；批准，同意
claim	|
decent	[ˈdiːsnt] a. 大方的，体面的，像样的；正派的，合乎礼仪的
itinerary	[aɪˈtɪnərərɪ] n. 行程表；旅行路线，旅行计划
supportive	[səˈpɔ:tɪv] a. 支持的，支援的；赞助的；鼓励的；同情的
transmute	[trænzˈmjuːt];[trænsˈmjuːt] v. 改变；（使）变化，变形，变质
revival	__revivial__ [rɪˈvaɪvl] n. （健康、力量或知觉的）恢复，复原；苏醒，复活；复兴；重新使用；重新流行
calculate	__caculate__ [ˈkælkjuleɪt] v. 计算，推算；估计，推测；计划，打算
cooperative	|
neoclassical	[ˏniːəuˈklæsɪkl] a. 新古典主义的
destruction	[dɪˈstrʌkʃn] n. 破坏，毁灭，摧毁
aspire	[əˈspaɪə(r)] v. 向往，渴望，追求；有志于，有抱负
crisis	[ˈkraɪsɪs] n. 危机；紧要关头，关键阶段
water-borne	['wɔ:təbɔ:n] a. 水运的，水传播的，饮水传染的
community	[kəˈmjuːnətɪ] n. 社会；社区；团体；（动植物的）群落；共同体
margin	|
category	[ˈkætəgərɪ] n. 种类；类别；范畴
tropospheric	[trɒpəʊ'sferɪk] a. 对流层的
elusive	[ɪˈluːsɪv] a. 难懂的，难捉摸的；易忘的
occur	[əˈkɜː(r)] vi. 发生；存在
clench	[klentʃ] v. 握紧；咬紧（牙关等）；牢牢抓住
culminate	[ˈkʌlmɪneɪt] vi. （以某种结果）告终；（在某一点）结束
endorse	[ɪnˈdɔːs] vt. 支持，赞同
clip	|
deadline	[ˈdedlaɪn] n. 最后期限
pervasive	__prevasive__ [pəˈveɪsɪv] a. 遍布的，弥漫的
aluminium	[ˏæljəˋmɪnɪəm] n. 铝
companion	[kəmˈpænɪən] n. 共事者；同伴
surroundings	[səˈraʊndɪŋz] n. 周围的事物，环境
sensitive	[ˈsensətɪv] a. 敏感的，灵敏的；神经过敏的，容易生气的；易受伤害的
bureaucracy	[bjuəˈrɔkrəsɪ] n. 官僚主义；官僚机构
audit	|
presentation	[ˏpreznˈteɪʃn] n. 赠送；赠品，礼物；授予，提供；显示；引荐，介绍；报告；表演，上演
approximate	|
overgraze	[ˌəʊvə'ɡreɪz] v. 过度放牧
refusal	[rɪˈfjuːzl] n. 拒绝
postpone	[pəˈspəun] v. 延迟，延期
mysterious	[mɪˈstɪərɪəs] a. 神秘的，诡秘的
divisional	[dɪ'vɪʒənl] a. 部门的
durable	|
exclusive	|
motivate	[ˈməutɪveɪt] vt. 使有动机；激励，激发
equity	[ˈekwətɪ] n. 公平，公正
demand	|
generalise	[ˈdʒenrəlaɪz] v. 概括；推广
solar-powered	['səʊlə paʊəd] a. 由太阳能驱动的
tap	[tæp] v. 轻拍；利用，开发
interest	|
plough	|
condense	[kənˈdens] v. （使）压缩，精简；（使）凝结
alternative	|
shaft	[ʃɑːft] n. 轴，柄，杆；矛柄，把柄；（光的）束，光线；竖井，（电梯的）升降井
federal	[ˈfedərəl] a. 联邦的，联盟的
flask	[flɑːsk] n. 长颈瓶；烧瓶
fabrication	[‚fæbrɪ'keɪʃn] n. 捏造，伪造；制作；构成
devastating	__devastationg__ [ˈdevəsteɪtɪŋ] a. 毁灭性的；强有力的
solve	[sɔlv] vt. 解答；解决
documentation	[ˌdɒkjumenˈteɪʃn] n. 文件证据，文献资料，文件
tariff	[ˈtærɪf] n. 关税，税率；（旅馆、饭店等的）价目表
grateful	[ˈgreɪtfl] a. 感激的，感谢的
grip	|
nourish	[ˈnʌrɪʃ] vt. 养育，滋养；培养（情绪、观点等）
graphology	[græˈfɔlədʒɪ] n. 笔迹学，笔相学
notorious	[nəuˈtɔːrɪəs] a. 著名的，众所周知的；声名狼藉的
unconquerable	[ʌnˈkɒŋkərəbl] a. 不可征服的
strap	|
contrived	[kənˈtraɪvd] a. 不自然的；人为的
sensory	[ˈsensəri] a. 感觉的，感官的
owl	[aul] n. 猫头鹰
dome	[dəum] n. 圆屋顶；穹顶
herdsman	['hɜ:dzmən] n. 牧人
estate	[ɪˈsteɪt] n. 个人财产，（尤指）遗产；土地，地产，（尤指）庄园
sponsor	|
specialist	['speʃəlɪst] n. 专家；专科医生
forgo	[fɔːˈgəu] vt. 放弃，抛弃；作罢
offensive	|
emergency	[ɪˈmɜːdʒənsɪ] n. 紧急情况，突发事件
internist	[ɪnˈtɜ:nɪst] n. 内科医生
metro	[ˈmetrəu] n. 地下铁路
denomination	[dɪˏnɔmɪˈneɪʃn] n. 命名；（货币等的）单位；宗教派别
ratio	[ˈreɪʃɪəu] n. 比，比率
perpetual	[pəˈpetʃuəl] a. 连续不断的；长期的；永久的
trunk	[trʌŋk] n. 树干，躯干；大箱子；象鼻
dolphin	[ˈdɔlfɪn] n. 海豚
bulk	[bʌlk] n. 大量；大批
moribund	[ˈmɔrɪbʌnd] a. 垂死的，即将灭亡的；即将结束的
scrub	|
dimension	[daɪˈmenʃn; dɪˈmenʃn] n. 尺寸，（长、宽、厚、深）度；方面、特点；维、元；[pl.] 面积
exclusively	[ɪk'skluːsɪvlɪ] ad. 专有地，专门地
formula	[ˈfɔːmjulə] n. 公式；配方；准则
evolve	[ɪˈvɔlv] v. （使）逐渐形成；（使）演变，（使）进化
code	|
well-being	[wel 'bi:ɪŋ] n. 安宁；福利
decibel	[ˈdesɪbel] n. 分贝
recreate	[ˌri:krɪ'eɪt] vt. 再现，再创造
curb	|
stake	|
slum	[slʌm] n. 贫民窟，贫民区
attentive	[əˈtentɪv] a. 注意的，专心的；关心的，体贴的；留意的
bewilder	[bɪˈwɪldə(r)] vt. 使迷惑，使昏乱
geometry	[dʒɪˈɔmətrɪ] n. 几何；几何学
rely	[rɪˈlaɪ] vi. 依靠；依赖
refinement	[rɪˈfaɪnmənt] n. 精巧的附件，精制的改良品；精炼；文雅
domination	[ˌdɒmɪ'neɪʃn] n. 控制，统治，支配
mate	|
booklet	[ˈbuklɪt] n. 小册子
convince	[kənˈvɪns] vt. （使）确信；说服
facility	[fəˈsɪlətɪ] n.[pl.] 设备，设施；便利条件
frustrate	[frʌˈstreɪt] vt. 使沮丧；挫败
compose	[kəmˈpəuz] v. 组成，构成；写，创作（乐曲等）；使安定
coffer	[ˈkɔfə(r)] n. 保险箱
apt	[æpt] a. 易于……的；适宜的；敏捷的
cucumber	[ˈkjuːkʌmbə(r)] n. 黄瓜
solution	[səˈluːʃn] n. 解答，解决办法；溶解，溶液
overexploit	[ˏəʊvərɪkˈsplɔɪt] vt. 过度开采
situated	[ˈsɪtʃueɪtɪd] a. 位于……的；处于……境地的
sip	[sɪp] v. 小口地喝；吸吮
security	[sɪˈkjuərətɪ] n. 安全，保障；抵押品；[pl.]证券
robotic	[rəʊ'bɒtɪk] a. 机器人的；像机器人的，呆板面机械的
controversy	[ˈkɔntrəvɜːsɪ] n. 争论，辩论，论战
relay	|
discount	|
survive	[səˈvaɪv] v. 活下来；幸免于；比……活得长，比……长命
dredge	[dredʒ] v. 挖掘；疏浚；挖出，吸出；重提（不愉快或令人难堪的）旧事
homestay	['həʊmsteɪ] n. 在当地居民家居住的时期
antiquated	[ˈæntɪkweɪtɪd] a. 陈旧的，过时的；废弃的
alignment	[əˈlaɪnmənt] n. 排成直线；联盟
statue	[ˈstætʃuː] n. 塑像
investigate	[ɪnˈvestɪgeɪt] v. 调查
incapacitate	[ˏɪnkəˈpæsɪteɪt] vt. 使无能力；使伤残；使不适合；使无资格
guarantee	|
announce	[əˈnauns] vt. 宣布；声称
gene	[dʒiːn] n. 基因
clamp	|
morality	[məˈrælətɪ] n. 道德，美德
emit	[ɪˈmɪt] vt. 发出（光、热、声音等），射出，散发，排放
prior	[ˈpraɪə(r)] a. 在前的，优先的
encapsulate	[ɪnˈkæpsjuleɪt] vt. 装入胶囊；压缩；总结，概述
decouple	[di:'kʌpl] v. 减弱，减少
modem	[ˈməudem] n. 调制解调器
in-favour-of	in favour of 赞同，支持
germinate	[ˈdʒɜːmɪneɪt] v. （使）发芽，（使）生长；发展
technique	[tekˈniːk] n. 技巧，技艺；技术，技能
poisonous	[ˈpɔɪzənəs] a. 有毒的，有害的；恶毒的，邪恶的
shark	[ʃɑːk] n. 鲨鱼；诈骗者
accountancy	[əˈkaʊntənsi] n. 会计工作，会计职业
tune	|
sore	|
immigrant	[ˈɪmɪgrənt] n. 移民；侨民
disintegrate	[dɪsˈɪntɪgreɪt] v. （使）碎裂，瓦解，解体
feature	|
grand	[grænd] a. 宏伟的；大的
embrace	[ɪmˈbreɪs] v./n. 拥抱；包括；欣然接受
utility	[juːˈtɪlətɪ] n. 功用，效用；[常pl.] 公用事业
turbid	[ˈtɜːbɪd] a. 混浊的；紊乱的
hostel	[ˈhɔstl] n. （青年）招待所；学生宿舍
supervisor	[ˈsu:pəvaɪzə(r)] n. 监督人，管理人，指导者；主管
ethical	[ˈeθɪkl] a. （有关）道德的；伦理的
crime	[kraɪm] n. 罪行；犯罪
invasion	[ɪnˈveɪʒn] n. 入侵，侵略
digestive	[dɪˈdʒestɪv] a. 消化的；和消化有关的
ceramic	|
relief	[rɪˈliːf] n. （痛苦等）减轻，解除；援救，救济；安慰；缓和剂
advisable	[ədˈvaɪzəbl] n. 可取的，适当的；明智的
passionate	[ˈpæʃənət] a. 充满激情的，热切的，狂热的
arithmetic	__arthmatic__ [əˈrɪθmətɪk] n. 算术
suspend	[səˈspend] vt. 吊，悬挂；推迟；暂停，中止
grant	|
mediocre	[ˏmiːdɪˈəukə(r)] a. 平庸的，平凡的
inculcate	[ˈɪnkʌlkeɪt] vt. 谆谆教诲，反复灌输
range	|
imagination	[ɪˏmædʒɪˈneɪʃn] n. 想象（力）；想象出来的事物
bistro	[ˈbiːstrəu] n. 小酒馆；小餐馆
solar	[ˈsəulə(r)] a. 太阳的；（利用）太阳能的
accustom	[əˈkʌstəm] vt. 使习惯于
spur	|
conference	[ˈkɔnfərəns] n. （正式）会议
halve	[hɑːv] v. 二等分，减半
clay	[kleɪ] n. 泥土，黏土
filter	|
fate	[feɪt] n. 命运，天数
priority	[praɪˈɔrətɪ] n. 优先（权），重点；优先考虑的事
interval	[ˈɪntəvl] n. 间隔，幕间休息；间距
for-instance	for instance 例如
resource	[rɪˈsɔːs; rɪˈzɔːs] n. [pl.] 资源，财力；应付办法，谋略；应变之才
stiff	|
inevitable	[ɪnˈevɪtəbl] a. 不可避免的，必然（发生）的
shell	|
pedigree	[ˈpedɪgriː] n. 家谱；门第；血统
vibrate	[vaɪˈbreɪt] v. （使）颤动
unconcerned	[ˏʌnkənˈsɜːnd] a. 漠不关心的；不烦恼的
leadership	[ˈli:dəʃɪp] n. 领导，领导层；领导能力
graduate	|
obtain	[əbˈteɪn] v. 获得，得到；通用，流行
undisguised	[ˌʌndɪsˈgaɪzd] a. 无伪装的；坦率的
formality	[fɔːˈmælətɪ] n. 认真遵循规范、礼节等；例行公事；正式手续
mosquito	[məsˈkiːtəu] n. 蚊子
inspect	[ɪnˈspekt] vt. 检查，检阅
mock	|
transcend	[trænˈsend] vt. 超越，胜过，优于
tug	[tʌg] v. 用力拖（或拉）
fancy	|
trek	[trek] vi./n. 牛拉车；艰苦跋涉
form	|
humanity	[hjuːˈmænətɪ] n. 人类，人；人性；人道，仁慈；[pl.] 人文学科
prominence	[ˈprɒmɪnəns] n. 突出，显著；卓越；重要
externally	__exsternally__ [ɪk'stɜ:nəlɪ] ad. 外表上，外形上
glacial	[ˈgleɪsɪəl] a. 冰期的；冰川的；寒冷的，冰冷的；冷若冰霜的
fairly	[feəlɪ] ad. 相当地；公平地；简直，完全地
stockpile	|
leisure	[ˈleʒə(r)] n. 空闲时间；悠闲
disposal	[dɪˈspəuzl] n. 处理，处置；布置，安排
union	[ˈjuːnɪən] n. 协会，工会，同盟；联合，合并
amaze	[əˈmeɪz] vt. 使惊奇，使惊愕
converse	|
resit	[ˏriːˈsɪt] v./n. 重修，补考
insularity	[ˌɪnsjʊ'lærətɪ] n. 岛国（状态）；与外界隔绝的生活状况；（思想、观点等的）褊狭
unquote	[ʌnˈkwəut] v. 结束引语
disfigure	[dɪsˈfɪgə(r)] vt. 使毁容，使变丑
fraud	[frɔːd] n. 诈骗罪；骗子；伪产品，冒牌货
amount	|
spacious	[ˈspeɪʃəs] a. 宽广的，宽敞的
patronage	[ˈpætrənɪdʒ] n. 赞助；支持；光顾；任免权
evidence	[ˈevɪdəns] n. 根据，证据 ；形迹，迹象
chapel	[ˈtʃæpl] n. 小教堂；祈祷室
extension	[ɪkˈstenʃn] n. 伸展；延长部分；电话分机
absolute	[ˈæbsəluːt] a. 完全的，绝对的，纯粹的
overlie	[ˌəʊvə'laɪ] v. 躺在……上面；置于……上面
bacterial	[bæk'tɪərɪəl] a. 细菌的；由细菌引起的
coherent	[kəʊ'hɪərənt] a. 条理清楚的，连贯的；一致的，协调的
fluency	[ˈflu:ənsi] n. 流利，流畅；通顺
bucket	[ˈbʌkɪt] n. 水桶
splendid	[ˈsplendɪd] a. 壮观的，壮丽的，极好的；堂皇的，豪华的；灿烂的，辉煌的
improve	[ɪmˈpruːv] v. 改善，改进
jerk	|
world-wide	__world-wild__ ['wɜ:ldwaɪd] a./ad. 遍及全球的/地
faulty	['fɔ:ltɪ] a. 有错误的，有缺点的；不完美的
constantly	[ˈkɒnstəntli] ad. 经常；不断地
onwards	[ˈɔnwədz] ad. 向前地，前进地
systematic	__systamatic__ [ˌsɪstəˈmætɪk] a. 系统的，体系的
specimen	[ˈspesɪmən] n. 范例，样品；样本，标本
overdraft	[ˈəuvədrɑːft] n. 透支；透支额
overfill	['əʊvə'fɪl] v. 装得太多，装到满溢
glue	|
extraordinary	[ɪkˈstrɔːdnrɪ] a. 不同寻常的，非常的
stick	[stɪk] v. 刺，戳；黏贴，黏住；卡住，陷住
fault	[fɔːlt] n. 缺点，瑕疵，毛病
fruitful	[ˈfruːtfl] a. 多产的，富饶的；富有成效的
notion	[ˈnəuʃn] n. 概念，观念；想法
limb	[lɪm] n. 肢，臂；树枝
beam	|
impede	[ɪmˈpiːd] vt. 阻碍，妨碍
triumphant	[traɪˈʌmfənt] a. 得胜的；得意洋洋的；狂欢的
rendition	[renˈdɪʃn] n. 表演，扮演，演唱；翻译；视觉再现
airtight	[ˈeətaɪt] a. 密闭的；无懈可击的
tramp	|
visible	[ˈvɪzəbl] a. 可见的，看得见的；有形的；明显的，显而易见的
anthropologist	[‚ænθrə'pɒlədʒɪst] n. 人类学家
swamp	|
haphazard	[hæpˈhæzəd] a. 无秩序的，无计划的，组织混乱的
downsize	['daʊnsaɪz] v. 缩小，紧缩
equipment	[ɪˈkwɪpmənt] n. 设备，装备
moral	|
sleek	|
fundamental	|
cope	[kəup] vi. （成功地）应付；（妥善地）处理
counter	|
pattern	|
invoice	|
opponent	|
consistent	__consistant__ [kənˈsɪstənt] a. 一致的，协调的；相符的，相容的
shin	|
outcome	[ˈautkʌm] n. 结果，成果；后果；结局；出口，输出量
accessory	[əkˈsesərɪ] n. 附件，零件；[常pl.] （尤指女性的）服装搭配物，装饰品；[律] 同谋，帮凶
assistance	__asistance__ [əˈsɪstəns] n. 协助，援助
inductive	[ɪnˈdʌktɪv] a. 诱导的，归纳的
tensile	[ˈtensaɪl] a. 拉力的，张力的；可延展的，可伸长的
aquarium	[əˈkweəriəm] n. 养鱼池；玻璃缸；水族馆
joint	|
glimpse	|
enforce	[ɪnˈfɔːs] vt. 实施，执行；强制，迫使
emission	[ɪˈmɪʃn] n. （光、热等的）散发；散发物
impetus	[ˈɪmpɪtəs] n. 推动，促进，刺激；推动力
regulate	__requlate__ [ˈregjuleɪt] v. 管制，控制；调节，校准；调整
veterinarian	[ˌvetərɪˈneəriən] n. 兽医
entire	[ɪnˈtaɪə(r)] a. 全部的，整个的
band	|
summarise	['sʌməraɪz] v. 总结，概括
redevelopment	[ˌri:dɪ'veləpmənt] n. 重新规划；重新建设
fossil	[ˈfɔsl] n. 化石；老顽固
resent	[rɪˈzent] v. 愤恨；对……表示愤恨，感到气愤
bind	[baɪnd] v. 捆绑，系；约束；凝结
conceive	[kənˈsiːv] v. （构）想出，构想，设想；怀孕
reiterate	[riːˈɪtəreɪt] vt. 重复，反复；反复地说，重申
gorilla	[gəˈrɪlə] n. 大猩猩
virtuous	['vɜ:tʃʊəs] ad. 有道德的，品性好的，品德高的；自命清高的；贞洁的
abode	[əˈbəud] n. 房屋，家，住所
gravity	[ˈgrævətɪ] n. 重力
litter	|
random	|
ascend	[əˈsend] v. 攀登；上升，升高
sorrow	[ˈsɔrəu] n. 悲哀；伤心事
petroleum	[pəˈtrəulɪəm] n. 石油
decipher	[dɪˈsaɪfə(r)] vt. 破译；解释
impact	[ˈɪmpækt] n. 影响，作用；冲击
truce	[truːs] n. 休战（协定）
hang	[hæŋ] v. 悬挂，吊，垂下；吊死，绞死
aptitude	[ˈæptɪtjuːd] n. 天资，天赋，天生的才能
hypothetical	[ˌhaɪpəˈθetɪkl] a. 假设的，假定的；爱猜想的
expire	[ɪkˈspaɪə(r)] v. 期满；终止
malleable	[ˈmælɪəbl] a. 可塑的；易改变的
harbour	|
heap	|
function	|
architect	[ˈɑːkɪtekt] n. 建筑师，设计师；创造者
maternal	[məˈtɜːnl] a. 母亲的；母系的
civilization	[ˏsɪvəlaɪˈzeɪʃn] n. 文明（社会），文化
flourish	|
assurance	[əˈʃʊərəns] n. 信心；保证；保险
regent	[ˈriːdʒənt] n. 摄政者（代国王统治者）
array	|
remedy	|
congested	[kənˈdʒestɪd] a. 拥挤不堪的；充塞的
shareholder	[ˈʃeəhəʊldə(r)] n. 股票持有人；股东
transcription	[trænˈskrɪpʃn] n. 抄写，誊写；抄本，誊本；书面标注的事物；（乐曲的）改编
acute	[əˈkjuːt] a. 灵敏的；剧烈的，猛烈的
debt	[det] n. 债，债务
discontinue	[ˏdɪskənˈtɪnjuː] v. 停止；中断；不连续
amplify	[ˈæmplɪfaɪ] v. 详述；放大（声音等）
onslaught	[ˈɔnslɔːt] n. 猛攻，猛袭
landward	[ˈlændwəd] a./ad. 向陆的/地，近陆的/地
invest	[ɪnˈvest] v. 投资；投入（时间、精力等）；授予，赋予
screen	|
alarm	|
tunnel	|
check-up	['tʃekʌp] n. 检查
resolve	|
mercury	[ˈmɜːkjurɪ] n. 水银
distill	[dɪs'tɪl] vt. （使）蒸馏，提取
strip	|
and-so-forth	and so forth 等等
collision	[kəˈlɪʒn] n. 碰撞；冲突，抵触
profit	|
bet	|
burst	|
navigable	[ˈnævɪgəbl] a. 可通航的；适于航行的
miracle	[ˈmɪrəkl] n. 奇迹；奇事
lawsuit	[ˈlɔ:su:t] n. 诉讼，起诉
abide	[əˈbaɪd] v. 停留，逗留；容忍，忍受
ideal	|
necessity	[nɪˈsesətɪ] n. 必然，必要；必需品；必要性
recapture	[ˏriːˈkæptʃə(r)] vt. 重获，收复
discipline	|
scamper	[ˈskæmpə(r)] vi. 奔跑，快跑
negotiate	[nɪˈgəuʃɪeɪt] v. 洽谈，协商；商定，达成；顺利通过
static	|
various	[ˈveərɪəs] a. 各种各样的；不同的；多方面的
diversion	[daɪˈvɜːʃn] n. 转向，转移，转换；转移视线的事物；娱乐
ozone-layer	__ozone__ __layer__ [ˈəuzəun ˈleiə] n.臭氧层
resident	|
monotonous	[məˈnɔtənəs] a. 单调的，无聊的
asymmetry	[ˌeɪ'sɪmətrɪ] n. 不对称
absurd	[əbˈsɜːd] a. 荒谬的，荒唐的
ascribe	[əˈskraɪb] vt. 把……归因于
seminar	[ˈsemɪnɑː(r)] n. （大学的）研究班，研讨会
pollinate	[ˈpɔləneɪt] vt.[植] 给……授粉
secondary	[ˈsekəndrɪ] a. 次要的，二级的；（教育、学校等）中等的；辅助的、从属的
tanker	[ˈtæŋkə(r)] n. 油轮；油罐车；加油飞机
ultraclean	['ʌltrəkli:n] a. 超净的，特净的
displace	[dɪsˈpleɪs] vt. 取代；迫使（人们）离开家园；撤职，使失业
supervise	[ˈsuːpəvaɪz] vt. 监督，管理；指导
deficiency	[dɪˈfɪʃnsɪ] n. 缺乏，不足
tutor	|
sedentary	[ˈsedntrɪ] a. （工作、活动等）需要久坐的；（人）惯于久坐不动的；（人或动物）定居的，不迁徙的；沉积的
vertical	|
encase	[ɪnˈkeɪs] vt. 装入，包住
faculty	[ˈfækltɪ] n. 才能；学院，系；（学院或系的）全体教学人员
arrogance	[ˈærəgəns] n. 傲慢，自大
generate	[ˈdʒenəreɪt] vt. 发生，生产（光、热、电等）；引起，导致
frock	[frɔk] n. 上衣；连衣裙
congratulate	[kənˈgrætʃuleɪt] vt. 祝贺
fertilise	[ˈfɜːtəlaɪz] vt. 使肥沃，使多产；施肥于；使受精
indigenous	[ɪnˈdɪdʒɪnəs] a. 土产的，本地的，本土的
upset	|
contact	|
ecliptic	[ɪ'klɪptɪk] n. [天] 黄道  a. 黄道的，日（或月）食的
hospitality	[ˏhɔspɪˈtælətɪ] n. （对客人的）友好款待，好客；盛情；招待礼节
fierce	[fɪəs] a. 凶猛的；强烈的
complementary	[ˌkɒmplɪˈmentri] a. 互补的；补充的，补足的
curly	['kɜ:lɪ] a. 卷曲的，波浪式的
grocery	['ɡrəʊsərɪ] n. 杂货店；食品，杂货
dull	[dʌl] a. 乏味的；阴沉的
infiltrate	[ˈɪnfɪltreɪt] v. （使）悄悄进入，潜入；渗入，渗透
astray	[əˈstreɪ] ad. 迷路地；误入歧途地
exhaustion	[ɪgˈzɔːstʃən] n. 精疲力竭；耗尽
declaration	[ˏdekləˈreɪʃn] n. 宣布；宣言，声明（书）
maturity	[mə'tʃʊərətɪ] n. 成熟；完善，完备，准备就绪；到期（应付款）
currently	[ˈkʌrəntli] ad. 当前，现时，目前
delivery	[dɪˈlɪvərɪ] n. 投递，交付；分娩
poverty	[ˈpɔvətɪ] n. 贫穷
vertebrate	|
materialistic	[məˌtɪəriəˈlɪstɪk] a. 唯物主义的；物质享乐主义的，贪图享乐的
distinguish	[dɪˈstɪŋgwɪʃ] v. 区别，辨别；辨认出；使杰出
disposable	[dɪˈspəuzəbl] a. 一次性的；可动用的
observe	[əbˈzɜːv] v. 察觉；观察；遵守
influential	__influencial__ [ˏɪnfluˈenʃl] a. 有影响力的；有权势的
reveal	[rɪˈviːl] vt. 揭露；泄露；展现
intake	[ˈɪnteɪk] n. 吸入，纳入；进气口，入口
consist	[kənˈsɪst] vi. 由……组成，由……构成；在于，存在于
waterfront	[ˈwɔ:təfrʌnt] n. 滨水路，滨水区，码头区
thigh	[θaɪ] n. 大腿
portion	|
reasonable	[ˈriːznəbl] a. 合理的，有道理的；通情达理的；适度的
medical	[ˈmedɪkl] a. 医学的，医疗的；内科的
accompany	[əˈkʌmpənɪ] vt. 陪伴；伴随，与……同时发生；伴奏
pledge	|
interview	[ˈɪntəvjuː] v./n. 接见，会见；采访；面试
popularity	[ˏpɔpjuˈlærətɪ] n. 普及，流行
allege	[əˈledʒ] vt. 断言，宣称
camel	[ˈkæml] n. 骆驼
delinquent	|
premier	|
conception	[kənˈsepʃn] n. 观念；概念
interact	[ˏɪntərˈækt] vt. 相互作用；相互影响
craft	[krɑːft] n. 工艺，手艺；船；航空器
reward	|
chronic	[ˈkrɔnɪk] a. （疾病）慢性的；积习难改的
easy-going	[ˈiːziˏgəuɪŋ] a. 脾气随和的，心平气和的；随便的
marginally	[ˈmɑ:dʒɪnəli] ad. 稍微，些微
exaggerate	[ɪgˈzædʒəreɪt] v. 夸大，夸张
household	|
champion	[ˈtʃæmpɪən] n. 冠军
layout	[ˈleɪaʊt] n. 布局，安排，设计
slim	[slɪm] a. 苗条的；薄的  vi. 变苗条
boulder	[ˈbəuldə(r)] n. 大石头；鹅卵石
disqualify	[dɪsˈkwɔlɪfaɪ] vt. 使丧失资格
celestial	[səˈlestiəl] a. 天体的，天上的
donation	[dəʊˈneɪʃn] n. 捐款；捐赠
wagon	[ˈwægən] n. 四轮马车；大篷车
inferior	|
corporal	|
crank	|
methane	[ˈmiːθeɪn] n. 甲烷，沼气
possess	[pəˈzes] vt. 具有；拥有
newsletter	['njuːzletə] n. 时事通讯，业务通讯
bother	|
limp	[lɪmp] a. 软的；无力的
broom	[bruːm] n. 扫帚
belt	[belt] n. 腰带；地带
bud	|
admission	[ədˈmɪʃn] n. 允许进入，加入权，进入权；招供，招认；入场券
explorer	[ɪkˈsplɔ:rə(r)] n. 勘探者，探险者
instruct	__instuct__ [ɪnˈstrʌkt] vt. 教导；指示，命令
barbaric	[bɑːˈbærɪk] a. 野蛮的，粗鲁的；残暴的，残忍的；原始部落的
inform	[ɪnˈfɔːm] v. 通知；向……报告
tube	[tjuːb] n. 管道，试管；<英> 地铁
bold	[bəuld] a. 粗（字）体的；大胆的，鲁莽的，勇敢的；醒目的
retailer	[ˈri:teɪlə(r)] n. 零售商人；复述者，传播者
acknowledge	[əkˈnɔlɪdʒ] v. 承认，确认；致意；感谢
droplet	[ˈdrɒplət] n. 小滴
abuse	|
hypnotic	|
predominate	[prɪˈdɔmɪneɪt] vi. 统治，支配；（数量、力量上）占优势
gang	|
irony	[ˈaɪərənɪ] n. 反话，讽刺；出人意料的事情
rank	|
computerize	__computarize__ [kəm'pju:təraɪz] vt. 使计算机化；用计算机做；用计算机储存（信息）
directory	[dəˈrektəri] n. 人名地址录；（电话）号码簿
affect	[əˈfekt] v. 影响；感染
pearl	[pɜːl] n. 珍珠
exhaustive	[ɪgˈzɔːstɪv] a. 包揽无遗的，彻底的，详尽的
sledge	[sledʒ] n. 雪橇  vi. 乘雪橇
underlying	[ˌʌndəˈlaɪɪŋ] a. 表面下的，下层的，在下面的；根本的；潜在的，隐含的
undertake	[ˏʌndəˈteɪk] v. 承担（某事物），负起（某事物的）责任；同意或答应做某事
dramatic	[drəˈmætɪk] a. 引人注目的；戏剧性的；激动人心的；戏剧的
eccentric	|
censure	[ˈsenʃə(r)] vt./n. 指责，谴责，责难
dormant	[ˈdɔːmənt] a. 休眠的；静止的；隐匿的
irrelevant	[ɪˈreləvənt] a. 不相关的；离题的
toxin	[ˈtɔksɪn] n. 毒素，毒质
fingerprint	['fɪŋɡəprɪnt] n. 指纹，手印
specific	[spəˈsɪfɪk] a. 特定的；明确的
blonde	|
spasm	[ˋspæzəm] n. 痉挛；抽搐；（活动、情感等的）突发、阵发
allowance	[əˈlauəns] n. 津贴；允许，容忍
hurl	[hɜːl] vt. 猛投，猛摔；大声叫骂
immediately	[ɪˈmi:diətli] ad. 立即，马上；紧接地；直接地
identify	__identity__ [aɪˈdentɪfaɪ] v. 认出，识别；辨别；查明；确定；视……（与……）为同一事物
thereby	[ˏðeəˈbaɪ] ad. 因此，从而
prowess	[ˈprauɪs] n. 杰出的才能，高超的技艺，专长，造诣
vitality	[vaɪˈtælətɪ] n. 生命力，活力
divert	[daɪˈvɜːt] vt. 使绕道，转移；娱乐，供消遣
censor	|
attract	[əˈtrækt] vt. 吸引，招引，引诱，引起（注意等）
personnel	[ˏpɜːsəˈnel] n. 全体人员，员工
extracurricular	[ˌekstrəkə'rɪkjʊlə] a. 课外的
attention	[əˈtenʃn] n. 注意（力），留心；立正
decline	[dɪˈklaɪn] n./v. 下降，减少；衰退，衰落
photography	[fəˈtɒgrəfi] n. 摄影术，摄影
instinctual	[ɪn'stɪŋktʃʊəl] a. 本能的
dash	|
occasionally	[əˈkeɪʒnəli] ad. 有时候，偶尔
verbal	[ˈvɜːbl] a. 口头的；言辞的，文字的，词语的；动词的
deploy	[dɪˈplɔɪ] vt. 部署；使用，运用
medication	[ˌmedɪˈkeɪʃn] n. 药；药物
responsibility	__responsiblity__ [rɪˏspɔnsəˈbɪlətɪ] n. 责任，责任心；职责，任务
prescription	[prɪˈskrɪpʃn] n. 处方，药方；开处方，开药方
colony	[ˈkɔlənɪ] n. 殖民地；（动植物的）群体
synthesis	[ˈsɪnθəsɪs] n. 综合，合成；综合体
brittle	[ˈbrɪtl] a. 易碎的，易损坏的；靠不住的；冷淡的，不友好的；（声音）尖利的
climatic	[klaɪˈmætɪk] a. 气候（上）的
restriction	[rɪ'strɪkʃn] n. 限制，约束
astronaut	[ˈæstrənɔːt] n. 宇航员
average	|
mechanism	[ˈmekənɪzəm] n. 机械装置；机制，机理；办法
plausible	[ˈplɔːzəbl] a. 似有道理的，貌似真实的；嘴巧的
approach	|
predominant	[prɪˈdɔmɪnənt] a. 卓越的，突出的；支配的，主要的，盛行的
equip	[ɪˈkwɪp] vt. 装备，配备；使有能力，使有准备
erode	[ɪˈrəud] v. 侵蚀，腐蚀；削弱，损害
transcript	['trænskrɪpt] n. 抄本，副本；文字记录
capsule	[ˈkæpsjuːl] n. 胶囊；航天舱，太空舱
friction	[ˈfrɪkʃn] n. 摩擦（力）；矛盾，冲突
infirmity	[ɪn'fɜ:mətɪ] n. 虚弱，衰弱
scandal	[ˈskændl] n. 丑事，丑闻；恶意诽谤；流言飞语；反感，愤慨
transform	[trænsˈfɔːm] v. 使改观，改革，改善；变换，把……转换成
mansion	[ˋmænʃən] n. 大厦；（豪华的）宅邸
invert	[ɪnˈvɜːt] vt. （使）倒转，（使）颠倒
upgrade	|
material	[məˈtɪərɪəl] n. 材料；素材  a. 物质的；重要的
discourteous	[dɪsˈkɜːtɪəs] a. 无礼的，粗鲁的
processor	[ˈprəʊsesə(r)] n. 加工机；加工工人；处理器
advanced	[ədˈvɑ:nst] a. 先进的
hectare	[ˈhekteə(r)] n. 公顷
appraisal	[əˈpreɪzl] n. 评估，评价
homesick	[ˈhəʊmsɪk] a. 想家的，思乡的
rectangular	[rek'tæŋɡjələ(r)] a. 长方形的，矩形的
commentary	[ˈkɔməntrɪ] n. （尤指电台或电视台所作的）实况报道，现场解说；注释，解释；批评；评价
beehive	[ˈbi:haɪv] n. 蜂窝；蜂箱
ventilation	[ˌventɪ'leɪʃn] n. 空气流通；通风设备，通风方法
alchemist	[ˈælkəmɪst] n. 炼金术士
approval	[əˈpruːvl] n. 赞成，同意；正式批准
furnish	[ˈfɜːnɪʃ] vt. 布置，为……配置家具；供应，提供；装备
tram	|
avenge	[əˈvendʒ] vt. 报仇，复仇，向（某人）报仇
frightened	[ˈfraɪtnd] a. 受惊的；受恐吓的
qualitative	[ˈkwɔlɪtətɪv] a. 性质的，质量的；定性的
replenish	[rɪˈplenɪʃ] vt. 再斟（或装）满；添加，补充
vacant	[ˈveɪkənt] a. 未占用的，空的
high-tech	[haɪ tek] n. 高科技
critic	[ˈkrɪtɪk] n. 批评家；爱挑剔的人
integral	[ˈɪntɪgrəl] a. 不可或缺的，构成整体所必需的；完整的，完备的
curtain	[ˈkɜːtn] n. 窗帘，门帘
subject	|
productive	[prəˈdʌktɪv] a. 生产性的；多产的；富有成效的
foundation	[faunˈdeɪʃn] n. 基础；地基；创立
recourse	[rɪˈkɔːs] n. 依靠；求助，求援
environment	[ɪnˈvaɪərənmənt] n. 周围状况；环境
graphic	[ˈgræfɪk] a. 文学的；生动的，形象的；绘画的，图表的
incendiary	[ɪnˈsendɪərɪ] a. 放火的，能引起燃烧的；煽动性的
detail	|
solicitor	[səˈlɪsɪtə(r)] n. （城镇的）法务官；初级律师，事务律师
visa	[ˈviːzə] n. 签证
chip	|
suspect	[səˈspekt] v. 猜想，怀疑
loyalty	[ˈlɔɪəlt] n. 忠诚，忠心
blank	[blæŋk] a. 空白的
severe	[sɪˈvɪə(r)] a. 严重的；严厉的；剧烈的
stereoscopic	[ˌsteriəˈskɒpɪk] a. 有立体视觉的；有立体效果的
deflect	[dɪˈflekt] v. （使）偏斜，（使）转向
ambiguity	[ˏæmbɪˈgjuːətɪ] n. 模棱两可；不明确
hire	[ˈhaɪə(r)] v./n. 租用；雇用
sack	|
autoimmune	[ˌɔ:təʊɪˈmju:n] a. 自身免疫的
major	|
define	[dɪˈfaɪn] vt. 下定义；限定
complete	|
fiction	[ˈfɪkʃn] n. 小说
jungle	[ˈdʒʌŋgl] n. 丛林
halt	|
mission	[ˈmɪʃn] n. 使命，任务；代表团，使团；传教，布道
megacity	['megəˌsɪtɪ] n. （人口超过1000万的）大城市
impart	[ɪmˈpɑːt] vt. 给予，赋予；传授；告知，透露
badminton	[ˈbædmɪntən] n. 羽毛球
habitat	[ˈhæbɪtæt] n. 栖息地，住处
enhance	__inhance__ [ɪnˈhɑːns] vt. 提高，增强；增进
scour	[ˈskauə(r)] vt. 四处搜寻，细查；擦洗，擦亮；冲刷出，冲刷成
enquiry	[ɪn'kwaɪərɪ] n. 询问；调查；探索
spouse	[spauz] n. 配偶
evaluate	[ɪˈvæljueɪt] vt. 评价，估价
subsoil	[ˈsʌbsɔɪl] n. 底土，下层土
candidate	[ˈkændɪdət] n. 候选人，候补者；申请求职者；报考者
award	|
internationalist	|
geological	[ˌdʒi:ə'lɒdʒɪkl] a. 地质的，地质学的
license	|
trigger	|
vacancy	[ˈveɪkənsɪ] n. 空位，空房间；（职位的）空缺，空职；无主意，空虚，茫然若失
dwell	[dwel] vi. 居住；栖身
viewpoint	[ˈvjuːpɔɪnt] n. 观点，看法
bilateral	[ˏbaɪˈlætərəl] a. 双边的；双方的
intersection	[‚ɪntə(r)'sekʃn] n. 道路交叉口，十字路口
ancient	[ˈeɪnʃənt] a. 古老的；年老的
loop	|
acceptable	[əkˈseptəbl] a. 可接受的
crater	[ˈkreɪtə(r)] n. 火山口；坑
monster	[ˈmɔnstə(r)] n. 怪物；巨人，庞然大物
section	[ˈsekʃn] n. 部分；部门；截面
preliminary	|
implement	|
sustain	[səˈsteɪn] v. 支撑，撑住，承受住；维持，保持；经受，遭受，忍耐
preparation	[ˏprepəˈreɪʃn] n. 准备（工作），预备；制剂
reunite	[ˏriːjuːˈnaɪt] v. （使）结合；（使）重聚
decisive	[dɪˈsaɪsɪv] a. 决定性的；果断的
bullet	[ˈbulɪt] n. 枪弹，子弹
resume	[rɪˈzjuːm] v. （中断后）重新开始，继续恢复
cavort	[kəˈvɔːt] v. 欢跃，跳跃；嬉戏
handle	|
melatonin	[ˌmelə'təʊnɪn] n. 褪黑激素
antique	|
molten	[ˈməultən] a. 熔化的
quantity	[ˈkwɔntətɪ] n. 数量，数目；量；众多，大宗
rig	|
discredit	[dɪsˈkredɪt] vt. 使怀疑；使丧失信誉，使丢脸
horizontal	[ˏhɔrɪˈzɔntl] a. 地平线的，水平的
forfeit	|
scrutiny	[ˈskruːtɪnɪ] n. 详细检查，细看；监视
alternate	|
at-least	at least 至少
parallel	|
splash	[splæʃ] v. 溅；泼
thoughtful	[ˈθɔ:tfl] a. 沉思的；体贴的
renaissance	__renainssance__ [rɪˈneɪsns] n. [the R-] （欧洲14至16世纪的）文艺复兴，文艺复兴时期；（文学、艺术等的）复兴、新生
commonwealth	[ˈkɔmənwelθ] n. [the C-] 英联邦；联合体
stab	[stæb] v. 刺，戳
unemployment	[ˏʌnɪmˈplɔɪmənt] n. 失业；失业人数
scope	[skəup] n. 眼界，见识；（活动、影响等的）范围；（发挥能力等的）余地，机会
commission	|
hazardous	['hæzədəs] a. 危险的，冒险的；有害的
concentrate	|
evaluation	[ɪˌvæljʊ'eɪʃn] n. 估价，评价
telegraph	|
cascade	[kæˈskeɪd] n. 小瀑布
hemisphere	[ˈhemɪsfɪə(r)] n. （地球的）半球；大脑半球
snack	[snæk] n. 快餐，小吃；点心
triple	|
outsell	[ˏautˈsel] vt. 卖得比……多
tend	[tend] v. 倾向于，趋于；照料；招待
derive	[dɪˈraɪv] v. 取得；起源
predatory	[ˈpredətrɪ] a. 食肉的；掠夺的
scout	|
nominal	[ˈnɔmɪnl] a. 名义上的；（金额、租金等）微不足道的
attempt	[əˈtempt] n./v. 尝试，试图；努力
service	|
scale	|
consensus	[kənˈsensəs] n. 共识；（意见）一致
continent	[ˈkɔntɪnənt] n. 大陆，陆地；洲
deem	[diːm] vt. 认为
dividend	[ˈdɪvɪdend] n. 红利，股息；回报，效益；被除数
pore-over	pore over [pɔːˈəuvə] 仔细阅读
enigma	[ɪˈnɪgmə] n. 迷，迷一样的人或事
penalize	[ˈpiːnəlaɪz] vt. 惩罚，处罚；判罚；使处于不利地位
obstacle	[ˈɔbstəkl] n. 障碍，妨碍物，干扰
turnover	[ˈtɜ:nəʊvə(r)] n. 营业额；人事变动率；货物周转率
loath	[ləuθ] a. 不情愿的，勉强的
earthwork	[ˈə:θwə:k] n. 土方（工程）
illusion	[ɪˈluːʒn] n. 幻想中的事物，错误的观念；错觉，幻觉，假象
populace	[ˈpɔpjuləs] n. （一个国家或地区的）人口，全体居民；平民，大众
pine	|
dietary	['daɪətərɪ] a. 饮食的
destination	[ˏdestɪˈneɪʃn] n. 目的地，终点；目标
pretentious	[prɪˈtenʃəs] a. 自命不凡的，自负的；炫耀的；做作的
induce	[ɪnˈdjuːs] vt. 引诱，劝使；引起，导致；感应
withdraw	[wɪðˈdrɔː] v. 收回；撤退；缩回，退出；提取（钱）
presence	[ˈprezns] n. 出席；存在；仪态
hurricane	[ˈhʌrɪkən] n. 飓风
ridiculous	[rɪˈdɪkjuləs] a. 荒谬的；可笑的
boot	[buːt] n. （长筒）靴子；（汽车后部的）行李箱；[the ~] 解雇
accreditation	[əˌkredɪˈteɪʃn] n. 证明合格，鉴定合格
optimistic	[ˌɒptɪˈmɪstɪk] a. 乐观的，乐观主义的
symphony	[ˈsɪmfənɪ] n. 交响乐
annual	|
adjust	[əˈdʒʌst] v. 校准；调节；使……适应
spray	|
personalize	[ˈpɜːsənəlaɪz] vt. 使成为私人的；在（物品）上标出主人姓名（或记号）；个人化
metaphorical	[ˌmetəˈfɒrɪkl] a. 隐喻的
conflict	|
fragile	[ˈfrædʒaɪl] a. 脆弱的；虚弱的；易碎的；易受伤害的
hybrid	|
assemble	__assenble__ [əˈsembl] v. 集合；装配
subordinate	|
plastic	[ˈplæstɪk] a. 塑料（制）的
contemplate	[ˈkɔntempleɪt] v. 思量，深思；注视，凝视；打算，预期
deterioration	[dɪˌtɪərɪə'reɪʃn] n. 恶化；堕落
invasive	[ɪnˈveɪsɪv] a. 侵略的，入侵的；（疾病等）侵袭的，扩散的；切入的，开刀的
reverse	|
reserved	[rɪˈzɜːvd] a. 说话不多的，内向的；有所保留的，预订的
precipitation	[prɪˏsɪpɪˈteɪʃn] n. 降雨（量），降水（量）；仓促，急躁； [化]沉淀作用
nationality	[ˏnæʃəˈnælətɪ] n. 国籍；民族
enable	[ɪˈneɪbl] vt. 使能够，使成为可能
acid	|
wage	[weɪdʒ] n. 工资；[常 pl.] 报酬
stretch	|
evaporate	[ɪˈvæpəreɪt] v. （使）蒸发；消失；不复存在
necessarily	[ˈnesəsərəlɪ; ˏnesəˈserəl] ad. 必要地；必然地
input	|
speculation	[ˏspekjuˈleɪʃn] n. 推测，思索；投机活动，投机买卖
handicapped	[ˈhændikæpt] a. 残废的，有生理缺陷的
bump-into	__bump__ __into__ [bʌmp ˈɪntuː] 不期而遇，邂逅
dominate	[ˈdɔmɪneɪt] v. 支配，统治；耸立于
shift	|
performance	__preforance__ [pəˈfɔːməns] n. 演出，表演；履行，执行；功能，性能表现
picturesque	[ˏpɪktʃəˈresk] a. 美丽如画的；（语言）生动的
enclosure	[ɪnˈkləuʒə(r)] n. 四周有篱笆（或围墙等）的场地，围场；（信中的）附件
colossal	[kəˈlɔsl] a. 巨大的，庞大的
liquor	[ˈlɪkə(r)] v. 烈性酒；含酒精饮料
intensify	[ɪn'tensɪfaɪ] vt. 使增强；使加剧
decoration	[ˏdekəˈreɪʃn] n. 装饰，装潢；装饰品
surveillance	[sɜːˈveɪləns] n. 监视，盯梢
bin	[bɪn] n. 大箱子；仓
capacity	[kəˈpæsətɪ] n. 容量，容积；能量，能力
attendance	|
virtue	[ˈvɜːtʃuː] n. 美德；优点
perpetuate	[pəˈpetʃueɪt] vt. 使永存；使持续
cloakroom	[ˈkləukrum] n. 衣帽间； <英> 洗手间
sporadically	[spə'rædɪklɪ] ad. 偶发地；零星地
seep	[siːp] vi. 漏出，渗漏
constrain	[kənˈstreɪn] vt. 迫使；约束
penetration	[ˏpenɪˈtreɪʃn] n. 进入，穿过；洞察力，领悟力
concede	[kənˈsiːd] v. （不情愿地）承认；让步
pavement	[ˈpeɪvmənt] n. 人行道；地面，路面
manufacture	|
dock	[dɔk] v. （使）靠码头  n. 码头
chill	[tʃɪl] v. （使）变冷，冷藏  n. 寒意；寒战；寒心  a. 寒冷的；扫兴的
autocratic	[ˌɔ:tə'krætɪk] a. 独裁的，专制的
conserve	[kənˈsɜːv] vt. 保护；保存，储存；节约
credible	[ˈkredəbl] a. 可信的，可靠的
renewal	[rɪˈnju:əl] n. 更新，恢复；重新开始；重建；复兴；续期；重申
eco-friendly	[ˌiːkəuˈfrendlɪ] a. 环保的
diagnose	[ˈdaɪəgnəuz] v. 诊断；判断
crisp	|
species	[ˈspiːʃiːz] n. 种，物种
mineral	[ˈmɪnərəl] n. 矿物，矿石
personality	[ˏpɜːsəˈnælətɪ] n. 人格；个性；名人，人物
panic	|
encroach	[ɪnˈkrəutʃ] vi. 侵入，侵占，侵犯；侵蚀，蚕食（土地）
stabilise	[ˈsteɪbəlaɪz] v. （使）稳定，（使）稳固
exemplify	[ɪgˈzemplɪfaɪ] vt. 作为……的典型；例证，举例说明
alert	|
glossy	['ɡlɒsɪ] a. 有光泽的，光滑的
habitable	[ˈhæbɪtəbl] a. 适于居住的，可居住的
trial	|
academic	|
astonish	[əˈstɔnɪʃ] vt. 使惊讶，使吃惊
stamp	|
savour	|
underneath	|
irrevocable	[ɪˈrevəkəbl] a. 无法取消的，不能改变的
flee	[fliː] v. 逃走；逃避
personal	[ˈpɜːsənl] a. 个人的，私人的；亲自的，本人的；身体的，人身的
creep	[kriːp] vi. 悄悄移动；缓慢进行；爬行
dimensional	[dɪ'menʃənəl] a. ……度空间的，……维的
crucial	[ˈkruːʃl] a. 决定性的；至关重要的
marsupial	[mɑːˈsuːpɪəl] n./a. 有袋动物（的）
certificate	[səˈtɪfɪkət] n. 证书，执照
mess	[mes] n. 凌乱  v. 弄糟，搞乱
imagine	[ɪˈmædʒɪn] v. 想象；猜想
recipe	[ˈresəpɪ] n. 食谱；方法，秘诀，秘方
certify	[ˈsɜːtɪfaɪ] vt. 证明，保证
essay	[ˈeseɪ] n. （作为课程作业的）短文、文章；评论文
lethal	[ˈliːθl] a. 致命的，破坏性的，毁灭性的；有害的
galaxy	[ˈgæləksɪ] n. [the G-] 银河；星系；群英
collection	[kəˈlekʃn] n. 收集，积聚；收藏（品）
microprocessor	[ˌmaɪkrəʊˈprəʊsesə(r)] n. 微处理器
confuse	[kənˈfjuːz] vt. 使混乱，混淆；使迷惑，使糊涂
perplex	[pəˈpleks] vt. 使困惑；使复杂化
brand	|
highway	[ˈhaɪweɪ] n. 公路
inspiration	[ˏɪnspəˈreɪʃn] n. 启示，灵感；鼓舞人心的人（或事），激励
output	|
staircase	[ˈsteəkeɪs] n. 楼梯
activate	[ˈæktɪveɪt] vt. 激活；使活动，使活化
jostle	[ˈdʒɔsl] v. 推挤；挤开通路
epidemic	[ˏepɪˈdemɪk] a. 流行性的  n. 流行病
cuisine	[kwɪˈziːn] n. 烹饪；烹调法，烹调风格；菜肴
absorb	[əbˈsɔːb] v. 吸收；吸引……的注意，使全神贯注；把……并入，同化
spite	[spaɪt] n. 恶意，怨恨
hook	|
irrigation	[ˌɪrɪ'ɡeɪʃn] n. 灌溉；冲洗
landfill	['lændfɪl]    n. 垃圾堆；垃圾填筑地，废渣埋填地
tilt	|
ion	[ˈaɪən] n. 离子
proceed	[prəˈsiːd] vi. 进行；前进；继续
stable	|
possession	[pəˈzeʃn] n. 持有，拥有；所有权；所有物，财产，财富；领土
depress	[dɪˈpres] vt. 使沮丧；使不景气；降低，减少
rampant	[ˈræmpənt] a. （犯罪、疾病等）猖獗的，肆虐的，泛滥的；（植物）蔓生的，疯长的
leather	[ˈleðə(r)] n. 皮革，皮革制品
denote	[dɪˈnəut] v. 表示，指示；意味着
global	[ˈgləubl] a. 全球的，全世界的；整体的，全面的
nutrition	[njuˈtrɪʃn] n. 营养；营养学
prominent	[ˈprɔmɪnənt] a. 突出的；著名的；显著的
guideline	[ˈgaɪdlaɪn] n. [常pl.] 指导方针；准则，行动纲领
formidable	[ˈfɔːmɪdəbl] a. 可怕的；难以应付的，难以克服的
scare	|
subjective	[səbˈdʒektɪv] a. 主观（上）的
refresher	__refrasher__ [rɪ'freʃə] n. 提神物；帮助记忆的东西或人；补习课程
forth	[fɔːθ] ad. 离去，外出；向前；向某处
atmospheric	[ˏætməsˈferɪk] a. 大气的，空气的；大气层的；大气所引起的
envisage	[ɪnˈvɪzɪdʒ] vt. 展望，想象；面对
unfortunately	[ʌnˈfɔ:tʃənətli] ad. 不幸地
enact	[ɪˈnækt] v. 通过（法律）；扮演（角色）
succeed	[səkˈsiːd] v. 成功；接着发生
aesthetic	[iːsˈθetɪk] a. 美学的；审美的
marker	['mɑ:kə(r)] n. 标记，标志
distinct	[dɪˈstɪŋkt] a. 清楚的，明显的；有区别的，不同的
grove	[grəuv] n. 树丛，小树丛
target	|
cosy	[ˋkəuzɪ] a. 舒适的，安逸的
revolve	[rɪˈvɔlv] v. （使）旋转
chamber	[ˈtʃeɪmbə(r)] n. 室；洞穴；（枪）膛
tough	[tʌf] a. 难对付的；健壮的；（肉等食物）老的
insert	[ɪnˈsɜːt] v. 插入，嵌入
pull-up-stakes	pull up stakes 离开，搬家
magnet	[ˈmægnɪt] n. 磁铁，磁石；磁体；有吸引力的人或物
disenchantment	[ˌdɪsɪn'tʃɑ:ntmənt] n. 失望，不抱幻想
inflate	[ɪnˈfleɪt] v. 使充气，使膨胀；使得意，使骄傲；抬高（物价），使（通货）膨胀
formulate	[ˈfɔːmjuleɪt] vt. 系统阐述，明确表达；构想出（计划、方法等），规划（制度等）
alienate	[ˈeɪlɪəneɪt] vt. 使疏远，使不友好；转让，让渡（财产等）
holistically	[həʊ'lɪstɪklɪ] ad. 整体地，全盘地
deny	[dɪˈnaɪ] v. 否认，否定；拒绝
abound	[əˈbaund] vi. 富于；充满
comparative	[kəmˈpærətɪv] a. 比较的；相当的
cookery	[ˈkukərɪ] n. 烹调法
include	[ɪnˈkluːd] v. 包括，包含；计入
congestion	[kənˈdʒestʃən] n. 拥挤，充塞；充血
defeat	[dɪˈfiːt] n./vt. 击败；挫败；战败
sincere	[sɪnˈsɪə(r)] a. 真挚的，诚挚的，真诚的，诚恳的
locality	[ləuˈkælətɪ] n. 位置；地区
offspring	[ˈɔfsprɪŋ] n. 子女，后代；产物
intrigue	|
competent	[ˈkɔmpɪtənt] a. 有能力的；能胜任的
shelter	|
magnificent	[mægˈnɪfɪsnt] a. 壮丽的，宏伟的，华丽的；高尚的
immigration	[‚ɪmɪ'greɪʃn] n. 外来的移民；移居
enlarge	[ɪnˈlɑːdʒ] v. 扩大，放大，扩充
deputy	[ˈdepjutɪ] n. 代理人；代表
spot	|
tendency	__trendency__ ['tendənsɪ] n. 倾向，趋向
soak	[səuk] v. 浸泡
incredible	[ɪnˈkredəbl] a. 不可信的；难以置信的
subscription	[səbˈskrɪpʃn] n. 订阅，订购；订阅费，订购款；捐赠，捐助；签字，签署
innovation	[ˌɪnəˈveɪʃn] n. 革新，创新
feeble	[ˈfiːbl] a. 虚弱的；无效的
intermix	[ˏɪntəˈmɪks] v. 混入，混杂
gorge	|
arable	|
treatment	[ˈtriːtmənt] n. 治疗；对待
smooth	[smuːð] a. 顺利的；流畅的；协调的
literate	[ˈlɪtərət] a. 有读写能力的；有文化的；博学的
diffuse	|
employ	[ɪmˈplɔɪ] n./vt. 雇用；用，使用
desirable	[dɪˈzaɪərəbl] a. 值得拥有的；合意的；可取的，有利的
mammal	[ˈmæml] n. 哺乳动物
frustration	[frʌ'streɪʃn] n. 沮丧，不满
mere	[mɪə(r)] a. 仅仅的；纯粹的
tragic	[ˈtrædʒɪk] a. 悲惨的；悲剧（性）的
hence	[hens] ad. 因此，所以；今后，从此
complexity	[kəm'pleksətɪ] n. 复杂，复杂性；复杂的事物
debate	[dɪˈbeɪt] n./v. 争论，辩论
career	[kəˈrɪə(r)] n. 生涯；经历；职业
moss	[mɔs] n. 苔藓
fair	[feə(r)] a./ad. 公平的/地
aviation	[ˏeɪvɪˈəɪʃn] n. 航空，飞行；航空制造业
exchange	|
chink	|
murder	[ˈmɜːdə(r)] n./v. 谋杀，凶杀
clinical	[ˈklɪnɪkl] a. 临床的；冷静客观的；简朴的，不装饰的
composition	[ˏkɔmpəˈzɪʃn] n. 作品；写作，作曲；结构，组成，成分
swallow	|
saturate	[ˈsætʃəreɪt] vt. 使湿透，浸透；使充满，使饱和
introspection	[ˌɪntrəˈspekʃn] n. 内省，反省
repack	[re'pæk] vt. 重新包装；重新填塞；再装配；拆修
drawback	[ˈdrɔːbæk] n. 缺点；不利条件
tranquility	[træŋ'kwɪlɪtɪ] n. 宁静，安静
version	[ˈvɜːʃn] n. 样式；型号；种类；说法；版本；译本
equivalent	|
explode	[ɪkˈspləud] v. （使）爆炸；爆发；激增
voltage	[ˈvəʊltɪdʒ] n. 电压
scrap	|
foul	|
mass	|
empirical	[ɪmˈpɪrɪkl] a. 经验主义的，以经验为依据的
undermine	[ˏʌndəˈmaɪn] vt. 削弱；破坏
predispose	[ˏpriːdɪˈspəuz] v. 事先（在某方面）影响某人；偏爱；（使）易受感染（或患病）
waterproof	['wɔ:təpru:f] a. 不透水的；防水的
perimeter	[pəˈrɪmɪtə(r)] n. 周长；周边
rumour	[ˈruːmə(r)] n. 谣传，谣言
pretend	[prɪˈtend] v. 装作，假装
govern	[ˈgʌvn] v. 统治，管理；控制，支配
definite	[ˈdefɪnət] a. 明确的，肯定的；清楚的
obsession	[əb'seʃn] n. 牵挂，惦念；迷住，困扰；萦绕于心的事物或人；固执的念头
absenteeism	[ˌæbsənˈti:ɪzəm] n. 旷课；旷工
disparage	[dɪˈspærɪdʒ] vt. 贬抑，贬低；轻蔑，轻视
impress	|
miserable	[ˈmɪzrəbl] a. 悲惨的，痛苦的；令人难受的
membership	[ˈmembəʃɪp] n. 会员身份；全体会员
diverge	[daɪˈvɜːdʒ] vi. （道路，线条等）分开，岔开；（意见、观点等）分歧，相异；偏离，违背
offset	[ˈɔfset] vt. 抵消，补偿，弥补
assault	|
external	[ɪkˈstɜːnl] a. 外面的，表面的
stage	[steɪdʒ] n. 舞台；戏剧；阶段
labour	|
floral	[ˈflɔːrəl] a. 花的，像花的；绘有花的，饰以花的；植物群的
gleam	|
contribute	[kənˈtrɪbjuːt] [ˈkɒntrɪbjuːt] v. 捐赠，捐助；起作用，影响
feedback	[ˈfiːdbæk] n. 反馈；反馈信息
beware	[bɪˈweə(r)] v. 谨防，当心
cognition	[kɔgˈnɪʃn] n. 感知，认知；认识力
architecture	[ˈɑːkɪtektʃə(r)] n. 建筑学；建筑设计，建筑风格, [计] 体系结构
authenticate	[ɔ:ˈθentɪkeɪt] vt. 鉴别，证明
zone	[zəun] n. 地区，地带；区域
moist	[mɔɪst] a. 湿润的，潮湿的
solidarity	__soliderity__ [ˏsɔlɪˈdærətɪ] n. 团结，一致
interplay	[ˈɪntəpleɪ] vi./n. 相互作用，相互影响
artificial	[ˏɑːtɪˈfɪʃl] a. 人工的，人造的；假的，矫揉造作的；模拟的
hamster	[ˈhæmstə(r)] n. 仓鼠
overcome	[ˏəuvəˈkʌm] vt. 战胜，克服；（感情等）压倒
insulation	[ˌɪnsjuˈleɪʃn] n. 隔绝，隔绝状态；绝缘（材料），隔热，隔音
enhancer	[ɪnˈhɑ:nsə(r)] n. 增强剂；放大器
retaliate	[rɪˈtælɪeɪt] vi. 报复，反击；复仇
avail	|
commiserate	[kəˈmɪzəreɪt] vi. 同情，怜悯
aisle	[aɪl] n. 走廊，通道；（教堂的）侧廊
chaos	[ˈkeɪɔs] n. 混乱
cumulative	__cumulatvie__ ['kju:mjələtɪv] a. 积累的，渐增的
squeeze	|
proportion	[prəˈpɔːʃn] n. 比例；部分；相称
appetite	__appetie__ [ˈæpɪtaɪt] n. 食欲，胃口；欲望
universe	[ˈjuːnɪvɜːs] n. 宇宙，天地万物；世界；领域
circumstance	[ˈsɜːkəmstəns] n. 环境；[pl.] 境况，情况
commerce	[ˈkɔmɜːs] n. 贸易，商业；交往，交流
merchandising	[ˈmɜ:tʃəndaɪzɪŋ] n. 销售规划
entrust	[ɪnˈtrʌst] vt. 委托，交付，托付
corridor	[ˈkɔrɪdɔː(r)] n. 过道，走廊
emulate	[ˈemjuleɪt] vt. 与……竞争，赶上；仿真，模仿
illegal	[ɪˈliːgl] a. 不合法的，违法的
cue	[kjuː] n. 暗示，提示
sundial	[ˈsʌndaɪəl] n. （通过太阳知道时间的）日规；日晷（仪）
MasterCard	[ˈmɑːstə(r)kɑːd] n. 万事达信用卡
sizeable	[ˈsaɪzəbl] a. 相当大的
ration	|
prerequisite	|
dispersal	[disˈpə:səl] n. 散布，分散；消散，疏散
compendium	[kəmˈpendɪəm] n. 简要，概略
sensation	[senˈseɪʃn] n. （感官的）感觉能力；感觉，知觉；轰动，引起轰动的事件（或人物）
allocate	[ˈæləkeɪt] vt. 分配；分派
hang-on	hang on  抓住；坚持下去；别挂断
acrobat	[ˈækrəbæt] n. 特技演员；杂技演员
blunt	|
pressure	|
purchase	|
internal	[ɪnˈtɜːnl] a. 内部的，国内的
figure	|
demonstrate	[ˈdemənstreɪt] v. 认证，证实；演示，说明；举行示威游行（或集会）
resistance	[rɪˈzɪstəns] n. 反抗，抵制；抵抗力，抵抗性；阻力；电阻
ejection	[ɪ'dʒekʃn] n. 喷出；排出物
supersede	[ˏsuːpəˈsiːd] vt. 代替，取代
biodiversity	[ˌbaɪəʊdaɪˈvɜ:səti] n. 生物多样性
divide	|
multiple	|
mountainous	[ˈmaʊntənəs] a. 多山的
trimester	[traɪˈmestə(r)] n. 三月期；学期
autonomy	[ɔ:ˈtɒnəmi] n. 自治，自治权；人身自由，自主权
persist	[pəˈsɪst] vi. 坚持；维持，保持，持续
assess	[əˈses] vt. 评定；估价
pragmatic	[prægˈmætɪk] a. 务实的；实事求是的；实用主义观点的
disillusionment	[ˌdɪsɪˈlu:ʒnmənt] n. 幻灭；觉醒，醒悟
stout	[staut] a. 发胖的，肥胖的，强壮的；结实的，牢固的；顽强的，坚毅的
parliament	[ˈpɑːləmənt] n. 议会，国会
resort	|
identifiable	[aɪˌdentɪˈfaɪəbl] a. 可辨认的，可识别的；可确定的，可证明是同一的
obligation	[ˏɔblɪˈgeɪʃn] n. 义务，职责，责任
veil	|
prevalence	['prevələns] n. 普及，流行，盛行
propellant	[prəˈpelənt] n. 喷射剂；推进物，推进剂
renew	[rɪˈnjuː] v. 重新开始；恢复；更换，更新；续借
management	[ˈmænɪdʒmənt] n. 管理（部门、人员）；处理
recreation	[ˏrekrɪˈeɪʃn] n. 娱乐，消遣
cannon	[ˈkænən] n. 加农炮，大炮
shrub	[ʃrʌb] n. 灌木
instinct	[ˈɪnstɪŋkt] n. 本能，直觉；天性
prediction	[prɪˈdɪkʃn] n. 预言，预料，预报
welfare	[ˈwelfeə(r)] n. 福利
addiction	[əˈdɪkʃn] n. 瘾；沉溺
saline	|
comb	|
naive	[naɪˈiːv] a. 幼稚的，天真的，不成熟的
individual	|
snap	|
predictable	___predictable_ [prɪˈdɪktəbl] a. 可预言的，可预报的；按老一套办事的，墨守成规的
speculate	[ˈspekjuleɪt] v. 推测；投机
indulge	[ɪnˈdʌldʒ] v. 沉溺于，纵情于；满足（欲望、兴趣等）；放纵，听任
telescope	[ˈtelɪskəup] n. 望远镜
seek	[siːk] v. 寻找；探索；追求
slide	|
devalue	[ˏdiːˈvæljuː] v. 使（货币）贬值；贬低
battery	__battary__ [ˈbætərɪ] n. 电池（组），蓄电池（组）
oppose	[əˈpəuz] v. 反对、反抗
resign	[rɪˈzaɪn] v. 辞职；辞去；放弃
machinery	[məˈʃi:nəri] n. <总称> 机械；机构
classical	[ˈklæsɪkl] a. 古典的；传统的；经典的
briefly	[ˈbri:fli] ad. 暂时地；简要地
residential	[ˏrezɪˈdenʃl] a. 居住的，住宅的；寄宿的
legal	[ˈliːgl] a. 法律的；合法的
grab	[græb] v./n. 抓，夺
crescent	|
concept	[ˈkɔnsept] n. 概念，观念；设想
municipal	[mjuːˈnɪsɪpl] a. 市的，市政的；地区的；内政的
thesis	[ˈθiːsɪs] n. 论文
freefone	[ˈfriːfəun] n. 免费电话
screw	|
cord	[kɔːd] n. 线；带
centennial	|
teamwork	[ˈti:mwɜ:k] n. 协力合作，团队合作；配合
steep	[stiːp] a. 陡峭的；（价格等）过高的；急剧的
front-line	[f'rʌntl'aɪn] a. 前线的；第一线的
unobtrusive	[ˏʌnəbˈtruːsɪv] a. 不显著的，不引人注目的；不张扬的
exhibition	[ˏeksɪˈbɪʃn] n. 展览（会）；陈列，展览
underestimate	|
federation	[‚fedə'reɪʃn] n. 联邦；同盟
penalty	[ˈpenltɪ] n. 惩罚；罚金
distraction	____ [dɪˈstrækʃn] n. 分散注意力的事；使人分心的事；娱乐，消遣
deceive	[dɪˈsiːv] v. 欺骗，蒙骗
conquer	[ˈkɔŋkə(r)] vt. 征服，战胜，占领；克服，破除（坏习惯等）
intimate	|
undergraduate	[ˏʌndəˈgrædʒuət] n. 大学本科生，大学生，大学肄业生
slice	|
trim	|
pronounceable	[prə'naʊnsəbl] a. （指声音）发得出的；（指词）可发音的
philosophy	[fɪˈlɔsəfɪ] n. 哲学；哲理
shore	[ʃɔː(r)] n. 滨，岸，海滩
remuneration	[rɪˌmju:nəˈreɪʃn] n. 报酬
concession	[kənˈseʃn] n. 让步，迁就；特许权；承认，认可
meteorology	__metearology__ [ˏmiːtɪəˈrɔlədʒɪ] n. 气象学
fantasy	[ˈfæntəsɪ] n. 想像
extreme	|
moderate	|
extent	[ɪkˈstent] n. 范围；面积；广度，长度；程度
superficial	[ˏsuːpəˈfɪʃl] a. 表面的；肤浅的
distance	[ˈdɪstəns] n. 距离；远方；一长段时间
redundant	[rɪˈdʌndənt] a. （因人员过剩而）被解雇的；多余的，过剩的；累赘的，冗长的
clumsy	[ˈklʌmzɪ] a. 笨拙的；不得体的
authority	[ɔːˈθɔrətɪ] n. 权力，管辖权； [pl.] 官方，当局；权威，专家
hesitate	[ˈhezɪteɪt] vi. 犹豫；不情愿
slat	|
bury	[ˈberɪ] vt. 埋葬；埋藏，掩藏
torment	|
intense	[ɪnˈtens] a. 强烈的，剧烈的；紧张的；热情的，热切的
document	|
appointment	[əˈpɔɪntmənt] n. 约会
disseminate	[dɪˈsemɪneɪt] v. 散布，传播
whereas	[ˏweərˈæz] conj. 然而，但是
tenable	[ˈtenəbl] a. 站得住脚的；可防守的
criterion	[kraɪˈtɪərɪən] n. 标准，准则
luxury	|
cohesion	[kəuˈhiːʒn] v. 结合，团结；凝聚力
carousel	[ˏkærəˈsel] n. 行李式传送带
urbanization	[ˌɜ:bənaɪ'zeɪʃn] n. 城市化，都市化
derelict	|
frustrating	[frʌˈstreɪtɪŋ] a. 令人泄气的，使人沮丧的
impression	[ɪmˈpreʃn] n. 印象，感想；印记，压痕
trustworthy	[ˈtrʌstwɜ:ði] a. 值得信赖的，可靠的
tribute	[ˈtrɪbjuːt] n. 贡品；颂词，称赞；（表示敬意的）礼物
discharge	|
squash	|
gadget	[ˈgædʒɪt] n. 小巧的器械，精巧的装置；小玩意
recruit	|
extinct	[ɪkˈstɪŋkt] a. 灭绝的；废弃的
division	[dɪˈvɪʒn] n. 分开，分隔；分配；分歧；除（法）；部门，科，司
condition	|
expel	[ɪkˈspel] vt. 把……开除；驱逐
recognize	[ˈrekəgnaɪz] vt. 认出；承认，认可
reliable	[rɪˈlaɪəbl] a. 可靠的，可依赖的
exhaust	|
erosion	[ɪ'rəʊʒn] n. 腐蚀；磨损
thermal	|
clerk	[klɑːk] n. 办事员；职员
fragment	|
coral	|
commencement	[kəˈmensmənt] n. 开始，开端；毕业典礼
recommendation	[ˌrekəmenˈdeɪʃn] n. 推荐，推荐信；劝告，建议
humane	[hjuːˈmeɪn] a. 善良的，人道的，仁慈的，慈悲的；（指学科）促进文明或教化的，人文的
commit	[kəˈmɪt] v. 把……交托给，提交；犯（错误），干（坏事）
sponge	|
recreational	[ˌrekriˈeɪʃənl] a. 消遣的，娱乐的；游戏的
boost	|
substance	[ˈsʌbstəns] n. 物质；实质
reputation	[ˏrepjuˈteɪʃn] n. 名誉，名声
simultaneously	[ˌsɪməl'teɪnɪəslɪ] ad. 同时地
glove	[glʌv] n. 手套
realm	[relm] n. 界，领域，范围；王国，国度
tag	|
maltreat	[ˏmælˈtriːt] vt. 虐待
slight	|
request	[rɪˈkwest] n./vt. 要求；请求
fumes	[fju:mz] n. 烟，气，汽
conductive	[kənˈdʌktɪv] a. 能传导电（或热）的，导电（或热）的
optimism	[ˈɔptɪmɪzəm] n. 乐观，乐观主义
tome	[təum] n. 册，大部头书；（有学术价值的）巨著
refundable	[rɪ'fʌndəbl] a. 可退还的，可归还的，可偿还的
liaise	[lɪˈeɪz] vi. 做联络人；联络，联系
staff	|
laboratory	[ləˈbɔrətrɪ] n. 实验室，研究室
infringe	[ɪnˈfrɪndʒ] v. 侵犯，侵害；违背，触犯（法规）；干涉，干扰
bachelor	[ˈbætʃələ(r)] n. 学士；单身汉
entice	[ɪnˈtaɪs] v. 怂恿，引诱
criminal	|
appeal	|
interpret	[ɪnˈtɜːprɪt] v. 解释，说明；口译，翻译
retail	|
antidote	[ˈæntɪdəut] n. 解毒药；矫正方法
plus	|
germ	[dʒɜːm] n. 微生物，细菌；起源，萌芽
valid	[ˈvælɪd] a. 有效的，具有法律效力的；正当的；有根据的，有理的
complicate	[ˈkɔmplɪkeɪt] vt. 使变复杂
pumice	|
inspiring	|
bilingual	[ˏbaɪˈlɪŋgwəl] a. （说）两种语言的
wrestle	[ˈresl] v. 摔跤；全力对付；用力移动
spasmodic	[spæzˈmɔdɪk] a. 痉挛的；间歇性的
endanger	[ɪnˈdeɪndʒə(r)] vt. 危及，危害
empire	[ˈempaɪə(r)] n. 帝国
discard	[dɪˈskɑːd] vt. 丢弃，遗弃
heighten	[ˈhaɪtn] v. （使）增强，（使）加剧
objection	[əbˈdʒekʃn] n. 反对；反对的理由
check	|
bolster	|
niggle	[ˈnɪgl] v. 拘泥小节；挑剔，吹毛求疵；为小事操心；不断地烦扰
handout	[ˈhændaʊt] n. 传单，分发的印刷品；救济品
analogy	[əˈnælədʒɪ] n. 类推；类比
militant	|
original	|
gigantic	[dʒaɪˈgæntɪk] a. 巨大的，庞大的
creation	[kriːˈeɪʃn] n. 创造；作品
eruption	[ɪ'rʌpʃn] n. （火山、战争等）爆发；（疾病）发作
get-off-track	get off track 离题，偏离目标
seam	[siːm] n. 缝，接缝；煤层
acrobatic	[ˌækrəˈbætɪk] a. 杂技的；杂技般的；杂技演员
tradition	[trəˈdɪʃn] n. 传统；惯例
verdict	[ˈvɜːdɪkt] n. 裁定；定论；判断；意见
slacken	[ˈslækən] v. （使）松弛，放松；放慢；萧条
voyage	[ˈvɔɪɪdʒ] n./v. 旅行，航行，飞行
provision	__prevision__ [prəˈvɪʒn] n. 供应，（一批）供应品；准备，预备；条款，规定；给养，口粮
graph	[grɑːf] n. 图，图表，曲线图
hesitation	[ˌhezɪ'teɪʃn] n. 犹豫，踌躇
effective	[ɪˈfektɪv] a. 有效的，生效的；给人深刻印象的，显著的
tan	|
improvement	[ɪm'pru:vmənt] n. 改进，进步；改进措施；改进处
insight	[ˈɪnsaɪt] n. 洞察力，深刻的了解；顿悟
pursuit	[pəˈsjuːt] n. 追求，寻求；[常pl.] 花时间和精力等做的事；消遣，爱好
region	[ˈriːdʒən] n. 地区；范围
insist	[ɪnˈsɪst] v. 坚持，坚决认为；一定要
relate	[rɪˈleɪt] v. 有关联；讲述，叙述
inescapable	[ˌɪnɪˈskeɪpəbl] a. 不可逃避的；难免的
sculpture	[ˈskʌlptʃə(r)] n. 雕塑品
inflammable	[ɪnˈflæməbl] a. 易燃的；易怒的
trivialize	['trɪvɪəlaɪz] vt. 使显得不重要，轻视，淡化
label	|
premise	[ˈpremɪs] n. 前提，假设；[pl.] （企业、机构等使用的）房屋和地基，经营场址
probe	|
iron	|
assistantship	[əˈsɪstəntʃɪp] n. （给研究生的）半工半读助学金，（大学）研究生助教奖学金
flame	|
facial	[ˈfeɪʃl] a. 面部的；面部用的
crockery	[ˈkrɔkərɪ] n. 陶器；瓦器
beneath	[bɪˈniːθ] prep./ad. 在下方
muscle	[ˈmʌsl] n. 肌肉；体力；力量，实力
avenue	[ˈævənjuː] n. 林荫道，大街；方法，途径
attain	[əˈteɪn] vt. 达到；获得；完成
expansion	[ɪkˈspænʃn] n. 扩大，扩张
Nordic	[ˈnɔːdɪk] a. 北欧人的；北欧国家的
significant	[sɪgˈnɪfɪkənt] a. 有意义的；重大的，重要的
optimum	[ˈɔptɪməm] a. 最好的；最有利的
transplant	|
comedy	[ˈkɔmədɪ] n. 喜剧；喜剧性（事件）
amorphous	[əˈmɔːfəs] a. 无固定形状的；无组织的
clientele	[ˏkliːənˈtel] n. （医生、律师等的）顾客，主顾，客户
helicopter	[ˈhelɪkɔptə(r)] n. 直升飞机
simplify	[ˈsɪmplɪfaɪ] vt. 使简化
simplicity	[sɪmˈplɪsətɪ] n. 简单（性），简易；朴素；直率，单纯
device	__divice__ [dɪˈvaɪs] n. 装置，设备，仪表；方法；设计；手段；策略
agriculture	[ˈægrɪkʌltʃə(r)] n. 农业；农学
sensible	[ˈsensəbl] a. 明智的；合情理的；能觉察到的
healing	|
stain	|
facsimile	[fækˈsɪməlɪ] n. 复制品；副本
uneasy	[ʌnˈiːzɪ] a. 心神不安的；担心的
county	[ˈkauntɪ] n. 郡，县
chemical	|
devastate	[ˈdevəsteɪt] vt. 破坏，毁坏；使震惊，使极为悲痛
malt	|
humidity	[hju:ˈmɪdəti] n. 湿度；潮湿
fulfillment	[fʊl'fɪlmənt] n. 履行；实现
conscious	__cautious__ [ˈkɔnʃəs] a. 自觉的；意识到的；神志清醒的
compress	|
automatically	[ˌɔ:tə'mætɪklɪ] ad. 自动地；无意识地
versatile	__verstile__ [ˈvɜːsətaɪl] a. 多才多艺的，多面手的；多用途的，通用的
prime	[praɪm] a. 首要的；最好的
combat	|
hockey	[ˈhɔkɪ] n. 曲棍球；冰球
symbol	[ˈsɪmbl] n. 象征；符号
pretension	[prɪˈtenʃn] n. 声称，自命；自负，自命不凡
medieval	[ˏmedɪˈiːvl] a. 中世纪的；中古（时代）的
tender	____ [ˈtendə(r)] a. 嫩的；脆弱的；温柔的
highlight	|
invade	[ɪnˈveɪd] v. 侵犯，侵入，侵略，侵袭
foremost	[ˈfɔːməust] a. 最好的；最重要的
convert	|
expense	[ɪkˈspens] n. 花费，开支；消费，消耗；代价，损失
fake	|
inject	[ɪnˈdʒekt] vt. 注射；注入，灌输
flush	|
decompression	[ˌdi:kəmˈpreʃn] n. 减压；减压室
minimise	[ˈmɪnɪmaɪz] vt. 使减到最低限度；最小化
equator	[ɪˈkweɪtə(r)] n. （地球）赤道
crushing	[ˈkrʌʃɪŋ] a. 惨重的，毁灭性的；压倒的，决定性的
temper	|
advocate	|
provided	[prəˈvaɪdɪd] conj. 倘若，只要，假如
majority	[məˈdʒɔrətɪ] n. 多数，大多数
interrupt	__interrupt_ [ˏɪntəˈrʌpt] v. 中断，中止；阻碍；打断，打扰
symptom	[ˈsɪmptəm] n. 症状；征候，征兆
vet	|
obscurity	__abscurity__ [əb'skjʊərətɪ] n. 模糊；费解；不出名
feed	|
sinew	[ˈsɪnjuː] n. 肌腱；力量的来源
rental	|
foresee	[fɔːˈsiː] vt. 预见，预知
noticeable	[ˈnəʊtɪsəbl] a. 显而易见的；明显的
loose	[luːs] a. 松的；散漫的；不精确的
intermediate	[ˏɪntəˈmiːdɪət] a. 中间的，中级的
grasp	|
superstitious	[ˌsu:pəˈstɪʃəs] a. 迷信的；根据迷信的，由迷信引起的；受迷信思想支配的
encourage	[ɪnˈkʌrɪdʒ] v. 鼓励；促进，激发
multinational	[ˏmʌltɪˈnæʃnəl] a. 多国的，多民族的；跨国公司的  n. 跨国公司
threaten	[θretn] v. 威胁，恐吓；预示（危险）快要来临；是……的征兆，可能发生
compensation	[ˏkɔmpenˈseɪʃn] n. 补偿，赔偿；赔偿物；赔偿金
in-comparison-with	in comparision with 与……比较起来
perpetrate	['pɜ:pətreɪt] vt. 做（坏事），犯（罪）
townscape	[ˈtaʊnskeɪp] n. 市镇风光
refreshment	[rɪˈfreʃmənt] n. （精力的）恢复；[pl.] 茶点，点心，饮料
hassle	[ˈhæsl] n. 困难，麻烦；分歧，争论
camper	___camper_ [ˈkæmpə(r)] n. 露营者，宿营者
enfranchise	__infranchise__ [ɪnˈfræntʃaɪz] vt. 给予……政治权利（尤指选举权）；解放（奴隶）
dweller	[ˈdwelə(r)] n. 居住者，居民
bit	[bɪt] n. 少许；小片；小块
operate	[ˈɔpəreɪt] v. 运转；动手术；起作用；操作；经营
intern	|
extravagant	[ɪkˈstrævəgənt] a. 奢侈的，铺张的；（言行等）无节制的，过分的，放肆的
landscape	|
reinforce	[ˏriːɪnˈfɔːs] vt. 加强；增援
hostility	[hɔˈstɪlətɪ] n. 敌意，敌对，对抗；抵制，反对，否决；[pl.] 交战，战争
on-the-horizon	on the horizon 即将发生的
restrict	[rɪˈstrɪkt] vt. 限制，约束
indispensable	__indespensable__ [ˏɪndɪˈspensəbl] a. 必不可少的，必需的
revelation	[ˏrevəˈleɪʃn] n. 被揭示的真相，（惊人的）新发现；揭示，显示；泄露
delinquency	[dɪˈlɪŋkwənsɪ] n. 失职；行为不良
slander	|
receptionist	[rɪ'sepʃənɪst] n. 接待员
hinge	|
groan	|
worthy	[ˈwɜːðɪ] a. 有价值的；值得的
stress	|
heal	[hiːl] v. 治愈，康复；调停
credit	|
evoke	[ɪˈvəuk] vt. 唤起
gland	[glænd] n. 腺
fieldwork	__fieldword__ [ˈfi:ldwɜ:k] n. 实地调查，野外考察
occasional	[əˈkeɪʒənl] a. 偶尔的，间或发生的
at-random	__at__  __random__ [æt ˈrændəm] 随便地，任意地
shipment	[ˈʃɪpmənt] n. 装运，运输；装载（或运输）的货物，装货量
literature	[ˈlɪtrətʃə(r)] n. 文学（作品）；文献
depart	[dɪˈpɑːt] vi. 离开，起程
domestic	[dəˈmestɪk] a. 本国的；家庭的；驯养的
viable	[ˈvaɪəbl] a. 可行的，可实施的； [生] 能自行生长发育的
backbone	[ˈbækbəʊn] n. 脊椎；骨干；支柱
deviance	['di:vɪəns] n. 异常；偏常行为
visual	[ˈvɪʒuəl] a. 视觉的，用于视觉的
initiative	[ɪˈnɪʃətɪv] n. 倡议，新方案；主动性，积极性；主动权
animate	|
costume	[ˈkɔstjuːm] n. 戏装；（特定场合穿的）成套服装
sluttish	[ˈslʌtɪʃ] a. 懒惰的，邋遢的；放荡的
engross	[ɪnˈgrəus] vt. 使全神贯注，占去（某人的）全部注意力和时间
conceal	[kənˈsiːl] vt. 隐藏；隐瞒；掩盖
latent	[ˈleɪtnt] a. 潜在的，潜伏的，不易察觉的
signature	[ˈsɪgnətʃə(r)] n. 签名，签字；签署
hike	|
infection	[ɪnˈfekʃn] n. 传染，感染，侵染，传播；传染病
accumulate	[əˈkju:mjəleɪt] v. 积累；堆积
concentration	[ˏkɔnsnˈtreɪʃn] n. 集中；专心，专注；浓缩，浓度
assert	[əˈsɜːt] v. 断言，声称；坚持
rarity	[ˈreərətɪ] n. 稀有；稀有的事物
glorious	[ˈglɔːrɪəs] a. 光荣的；壮丽的
distortion	[dɪ'stɔ:ʃn] n. 扭曲，变形；曲解，歪曲
whaling	['weɪlɪŋ] n. 捕鲸
plagiarism	[ˈpleɪdʒərɪzəm] n. （文学、学说等的）剽窃，抄袭；剽窃物
illustrate	[ˈɪləstreɪt] v. （用图等）说明，举例说明，阐明；给……作插图说明
monumental	[ˏmɔnjuˈmentl] a. 纪念碑的，纪念物的；不朽的，有重大意义的
invader	[ɪn'veɪdə(r)] n. 入侵者
humanistic	[ˌhju:mə'nɪstɪk] a. 人文主义的，人性的
transition	[trænˈzɪʃn] n. 过渡，过渡时期；转变，转换，变革
mime	|
combine	[kəmˈbaɪn] v. 联合，结合
irritable	[ˈɪrɪtəbl] a. 急躁的，易怒的，易受刺激的；过敏的
commercial	|
likelihood	[ˈlaɪklihʊd] n. 可能；可能性
president	[ˈprezɪdənt] n. 总统，校长，会长，（大会）主席
calibre	[ˈkælɪbə(r)] n. 质量，才干，能力；口径
controversial	[ˏkɔntrəˈvɜːʃl] a. 争论的
imitate	[ˈɪmɪteɪt] vt. 模仿，模拟；仿效
equation	[ɪˈkweɪʒn] n. 方程式，等式；平衡；等同，相等
distract	[dɪˈstrækt] vt. 转移（注意力）；使分心
manufacturer	[ˌmænjuˈfæktʃərə(r)] n. 制造商，制造厂，生产者
cherry	[ˈtʃerɪ] n. 樱桃（树）
suicidal	[ˌsu:ɪˈsaɪdl] a. 自杀（性）的；有自杀倾向的
independence	[ˏɪndɪˈpendəns] n. 独立，自主
humid	[ˈhjuːmɪd] a. 湿的，潮湿的，湿润的，多潮气的
hover	[ˈhɔvə(r)] v. （鸟等）翱翔，盘旋；逗留在近旁，徘徊；彷徨，犹豫
advance	|
dedicate	[ˈdedɪkeɪt] vt. 献（身）；（在著作等上）题献词
flavour	|
excess	|
combination	[ˏkɔmbɪˈneɪʃn] n. 结合（体），联合（体）；化合
gregarious	[grɪˈgeərɪəs] a. 群居的；合群的；爱交际的
motion	|
prosper	[ˈprɔspə(r)] vi. 繁荣，兴旺；成功
constant	[ˈkɔnstənt] a. 经常的，不断的；坚定的，永恒的，忠实的；持续的，不变的  n. 常数，恒量
intellectual	|
incompatible	[ˏɪŋkəmˈpætəbl] a. 不兼容的，不能和谐共存的，不协调的，合不来的
apace	[əˈpeɪs] ad. 快速地，急速地
pilot	|
fluctuation	[ˌflʌktʃʊ'eɪʃn] n. 波动，起伏；动摇
counsel	|
correlation	[ˌkɒrəˈleɪʃn] n. 相互关系，相关（性）
worthwhile	[ˌwɜ:θˈwaɪl] a. 值得花费时间（或金钱）的，值得做的
advent	[ˈædvənt] n. 到来；出现
predator	[ˈpredətə(r)] n. 捕食性动物；食肉动物；奴役他人者（尤指在财务或性关系上面）；剥削者，掠夺者
effort	[ˈefət] n. 努力，艰难的尝试；成就
host	|
fleet	|
propose	[prəˈpəuz] v. 提议，建议；提名，推荐；打算；（向某人）求婚
devote	[dɪˈvəut] vt. 将……奉献给；致力（于）
yield	|
minister	[ˈmɪnɪstə(r)] n. 部长；外交使节；牧师
deter	[dɪˈtɜː(r)] v. 威慑，吓住，（使）断念
odour	[ˈəudə(r)] n. 气味
ongoing	|
illustration	[ˌɪləˈstreɪʃn] n. 说明；实例；图解，插图
venue	[ˈvenjuː] n. （聚焦、审判、比赛等的）地点
elucidate	[ɪˈluːsɪdeɪt] vt. 阐明，使……清楚
furnace	[ˈfɜːnɪs] n. 熔炉
grid	[grɪd] n. 格子，栅格；地图上的坐标方向；输电网，煤气输送网
acclimatise	___acclimatise_ [əˈklaɪmətaɪz] v. （使……）服水土；（使……）适应新环境
virtually	[ˈvɜ:tʃuəli] ad. 几乎，差不多；实际上，事实上
compete	[kəmˈpiːt] vi. 竞争；比赛
perceive	[pəˈsiːv] vt. 感知，察觉；认识到，理解
allergic	[əˈlɜ:dʒɪk] n. 过敏的，（对……）变态反应的，变应性的
imprecise	[ˏɪmprɪˈsaɪs] a. 不精确的，不严密的
variation	[ˏveərɪˈeɪʃn] n. 变化，变动；变种；变异；变更；变奏
substitute	|
boast	[bəust] n./v. 自夸；夸耀
issue	|
longitude	[ˈlɔndʒɪtjuːd] n. 经度，经线
contrast	|
standard	|
urge	[ɜːdʒ] v. 敦促，力劝；鼓励；竭力主张
algebra	[ˈældʒɪbrə] n. 代数
patent	|
payment	[ˈpeɪmənt] n. 支付；支付的款项
conversation	[ˏkɔnvəˈseɪʃn] n. 会话，谈话
repertoire	__repotoire__ [ˈrepətwɑː(r)] n. （剧团等）常备剧目；（剧团、演员等的）全部节目
retire	[rɪˈtaɪə(r)] v. 退休；引退，退隐，撤退
headline	[ˈhedlaɪn] n. 大字标题；[常pl.] 头版头条新闻
primary	[ˈpraɪmərɪ] a. 最初的，初级的；首要的，基本的
spill	[spɪl] v. （使）溢出；涌出
headquarters	[ˈhedˈkwɔ:təz] n. 总部，总公司；大本营；司令部
exceptional	[ɪkˈsepʃənl] a. 例外的；异常的
avoid	__aviod__ [əˈvɔɪd] vt. 避免；躲开
imperil	[ɪmˈperəl] vt. 使陷于危险，危及
weaken	['wi:kən] v. （使）变弱，（使）减弱
goggles	[ˈgɔglz] n. 护目镜；风镜；游泳镜
contrive	[kənˈtraɪv] v. 计划，图谋；设计；发明
parental	[pəˈrentl] a. 父的；母的；父母（般）的
contemporary	|
contrary	|
reciprocate	[rɪˈsɪprəkeɪt] v. 回报，回应；报答
fickle	__fickel__ [ˈfɪkl] a. 易变的，无常的
deliberate	|
patriotic	[ˌpætriˈɔtik] a. 爱国的，有爱国心的；显示出爱国精神的
acquaint	[əˈkweɪnt] vt. （使）认识；（使）熟悉
instrument	[ˋɪnstrəmənt] n. 仪器；手段；工具；乐器
receipt	[rɪˈsiːt] n. 收到，接到；发票，收据；[pl.] 收入，进款
consulate	[ˈkɒnsjələt] n. 领事馆；领事职位，领事任期
modish	[ˈməudɪʃ] a. 流行的，时髦的
attraction	[əˈtrækʃn] n. 爱慕，吸引；吸引力；具有吸引力的事（或人）
keen	[kiːn] a. 热衷的，热心的，渴望的；敏锐的，敏捷的；激烈的，紧张的；锋利的
address	|
justice	[ˈdʒʌstɪs] n. 正义，公正；司法
humour	[ˈhjuːmə(r)] n. 幽默，幽默感
lack	[læk] n./vt. 缺乏，不足，没有
accredit	[əˈkredɪt] vt. 信任，相信，委任，授权；把……归于
stipulate	[ˈstɪpjuleɪt] v. 规定，明确要求；（作为条件）讲定，约定
finance	|
urgent	[ˈɜːdʒənt] a. 紧急的，紧迫的；催促的，急切的
grassy	['ɡrɑ:sɪ] a. 草绿色的；似草的
huddle	|
attach	[əˈtætʃ] v. 系，贴；认为有重要性（或意义，价值等）；使附属，附加
overlapping	[əʊvə'læpɪŋ] a. 重叠的；共通的
thrill	[θrɪl] v. （使）非常激动；（使）发抖
amass	[əˈmæs] vt. 积聚
statistic	[stəˈtɪstɪk] n. 统计数值；统计学
digital	[ˈdɪdʒɪtl] a. 数码的，数字的
opaque	__outsell__ [əuˈpeɪk] a. 不透明的；晦涩的，难懂的
seclude	[sɪˈkluːd] vt. 使隔离，使孤立
cultivate	[ˈkʌltɪveɪt] vt. 种植；培养
posture	[ˈpɔstʃə(r)] n. 姿势；心情；态度
collapse	[kəˈlæps] v./n. 坍塌，崩溃；晕倒
fallow	[ˈfæləu] a. （土地）休耕的；休闲的
compact	|
basis	[ˈbeɪsɪs] n. 基础；根据；原则
refer	[rɪˈfɜː(r)] v. 参考，查阅，查询；提到，谈及；引用；提交，上呈
bouncing	[ˈbaʊnsɪŋ] a. 健壮的，茁壮的
pesticide	[ˈpestɪsaɪd] n. 杀虫剂，农药
limitation	[ˏlɪmɪˈteɪʃn] n. 限制；局限
earthworm	[ˈɜ:θˌwɜ:m] n. 蚯蚓；小人
opulence	['ɒpjələns] n. 财富，富裕；丰富，富饶
cruise	|
ecological	[ˌi:kəˈlɒdʒɪkl] a. 生态学的，生态的
string	|
Mediterranean	|
reputable	[ˈrepjutəbl] a. 名声好的，高尚的；受尊敬的；值得信赖的
variability	[ˌveəriəˈbɪləti] n. 可变性，易变性
character	[ˈkærəktə(r)] n. 性格，品质；性质，特性；人物，角色；（书写或印刷）符号，（汉）字
mishandle	[ˏmɪsˈhændl] vt. 粗暴地对待；错误地处理，胡乱操作
apportion	[əˈpɔːʃn] vt. 分派，（按比例或计划）分配
nutritional	[njʊ'trɪʃənl] a. 营养的，滋养的；营养物的，食物的
rescue	[ˈreskjuː] n./vt. 营救，救援
surf	[sɜːf] v. 冲浪
chancellor	__chansellor__ [ˈtʃɑːnsələ(r)] n. 大臣；总理；首席法官；大学校长
consequential	[ˏkɔnsɪˈkwenʃl] a. 结果的，随之发生的
quartz	[kwɔːts] n. 石英
lull	[lʌl] n. 间歇，暂停；平静期
contradiction	[ˌkɒntrəˈdɪkʃn] n. 矛盾，不一致；否认，反驳
suitable	[ˈsuːtəbl] a. 适当的，相配的；合适的，适宜的
delegate	|
compile	[kəmˈpaɪl] vt. 汇编；编纂
addict	[ˈædɪkt] n. 吸毒成瘾的人，有瘾的人，对……入迷的人
secure	|
minimal	[ˈmɪnɪməl] a. 最小的，最低限度的
defendant	|
anchor	|
scrape	[skreɪp] v./n. 刮，擦
transit	|
vacation	[vəˈkeɪʃn] n. 假期；休假
overlap	[ˏəuvəˈlæp] v. （使）部分重叠，交叠
bonus	[ˈbəunəs] n. 资金，红利；好处
anticipation	[ænˏtɪsɪˈpeɪʃn] n. 预料
advertisement	[ədˈvɜ:tɪsmənt] n. 广告，公告；广告活动，宣传
specialty	[ˈspeʃəlti] n. 特产；特长
voluntary	[ˈvɔləntrɪ] a. 自愿的，志愿的
anecdotal	[ˌænɪkˈdəʊtl] a. 轶话的，轶闻趣事的
acclaim	|
coverage	[ˈkʌvərɪdʒ] n. 新闻报道；覆盖范围
aggressive	[əˈgresɪv] a. 侵犯的，侵略的；挑衅的；有进取心的，有冲劲的
exacerbate	[ɪgˈzæsəbeɪt] vt. 恶化，加剧
persuade	[pəˈsweɪd] v. 说服，劝说；使相信
identical	[aɪˈdentɪkl] a. 完全相同的，同一的
eternal	[ɪˈtɜːnl] a. 永恒的
legislation	[ˌledʒɪsˈleɪʃn] n. 法律，法规；立法
valuable	|
snap-up	snap up 抢购
uncertainty	[ʌn'sɜ:tntɪ] n. 犹豫，迟疑；不确定；无把握
trespass	[ˈtrespəs] vi. 侵犯（某人的财产）；擅闯（某人的领地）；利用（某物）；冒犯，触犯
isolated	['aɪsəleɪtɪd] a. 隔离的，分离的；与世隔绝的，偏僻的；孤立的，孤独的；个别的
fade	[feɪd] v. （使）变淡，变暗；褪色；凋谢；逐渐消失
curriculum	[kəˈrɪkjuləm] n. 课程，（学校等的）全部课程
negative	|
narrator	[nəˈreɪtə(r)] n. 讲述者，叙述者
decorate	[ˈdekəreɪt] v. 装饰，装潢，布置；授勋
precarious	[prɪˈkeərɪəs] a. 不安全的，充满危险的；不牢靠的，不稳固的
charge	|
hiccup	|
distinctive	__distinctive_ [dɪˈstɪŋktɪv] a. 出众的；有特色的
flip	[flɪp] v. 轻抛；轻弹
charter	|
obstruct	[əbˈstrʌkt] v. 妨碍，阻止；阻塞；截断
unsatisfactory	[ˌʌnˌsætɪsˈfæktəri] a. 不能令人满意的
declare	[dɪˈkleə(r)] v. 正式宣布；声明；断言
prefabricate	[ˏpriːˈfæbrɪkeɪt] vt. 预制构件（用以组装建筑物、船舶等）
prospectus	[prəˈspektəs] n. 内容说明书，简章，简介
physical	|
analysis	[əˈnæləsɪs] n. 分析，分解
ferry	|
drainage	[ˈdreɪnɪdʒ] n. 排水（系统）
sympathise	['sɪmpəθaɪz] vi. 同情；赞同
retrenchment	[rɪ'trentʃmənt] n. 节省；削减
capsize	[kæpˈsaɪz] v. （使船）翻，倾履
explosive	|
horrify	[ˈhɔrɪfaɪ] vt. 使恐惧，使惊骇；使震惊；使感到厌恶
gender	[ˈdʒendə(r)] n. 性别；（语法中的）性
batch	[bætʃ] n. 一批，一组，一群；一批生产量
avalanche	__avalanch__ [ˈævəlɑːnʃ] n./v. 雪崩
survey	|
opportunity	[ˏɔpəˈtjuːnətɪ] n. 机会，时机
adobe	[əˈdəubɪ] n. 土坯，泥砖
highland	['haɪlənd] n. 高地，高原
owe	[əu] vt. 欠；把……归功于
inscribe	[ɪnˈskraɪb] v. （在某物上）写、题、铭刻；牢记，铭记
contingency	[kənˈtɪndʒənsɪ] n. 偶然性，可能性；意外事件；附带事件
harsh	[hɑːʃ] a. 严厉的，严酷的；粗糙的，毛糙的；刻薄的；（天气或生活环境）恶劣的；刺耳的，刺目的
exploitation	[ˌeksplɔɪˈteɪʃn] n. 开采，开发；剥削，榨取；自私的利用
select	|
military	|
perspective	[pəˈspektɪv] n. （判断事物的）角度，方法；透视法
creative	[kriːˈeɪtɪv] a. 创造性的；创作的
seasonal	[ˈsiːzənl] a. 季节性的，随季节而变化的；节令性的
landmark	[ˈlændmɑ:k] n. 路标，地标；里程碑
esteem	[ɪˈstiːm] n./vt. 尊重；尊敬
proximity	[prɔkˈsɪmətɪ] n. 接近，邻近；亲近
in-vain	in vain 徒然，无效例
resemble	[rɪˈzembl] vt. 与……相似，像
cricket	[ˈkrɪkɪt] n. 板球；蟋蟀
spiritual	[ˈspɪrɪtʃuəl] a. 精神的；心灵的；宗教的
roam	|
analogous	[əˈnæləgəs] a. 类似的
given	[ˈgɪvn] a. 规定的，特定的；假设的
postcode	[ˈpəʊstkəʊd] n. 邮政编码
maximise	[ˈmæksɪmaɪz] vt. 使增加到最大限度，最佳化；充分利用
assignment	[əˈsaɪnmənt] n. 任务，工作
sophisticated	[səˈfɪstɪkeɪtɪd] a. 老于世故的，老练的；精密的，尖端的，先进的；复杂的；高雅的，有教养的
reduce	[rɪˈdjuːs] v. 减少，缩小；简化
slothful	[ˈsləuθfəl] a. 怠惰的，懒惰的；迟钝的
pepper	|
pamper	[ˈpæmpə(r)] vt. 纵容，娇惯；精心护理
truant	|
revise	[rɪˈvaɪz] v. 修订；复习
centrifugal-force	__centrifugal__ __force__ [senˈtrɪfjəgəl fɔ:s] n. 离心力
historian	[hɪˈstɔːrɪən] n. 历史学家，历史学工作者
constitution	[ˏkɔnstɪˈtjuːʃn] n. 宪法，章程；体质，体格；组成，形成
inland	[ˈɪnlænd] a. 内陆的
incinerate	[ɪnˈsɪnəreɪt] vt. 焚化，焚毁，把……烧成灰烬
underling	[ˈʌndəlɪŋ] n. 职位低的人，下属
repaint	[ri:'peɪnt] v. 重新油漆，重画
crude	[kruːd] a. 天然的；粗糙的；粗俗的
reel	|
potential	|
essential	|
apply	[əˈplaɪ] v. 申请；应用，使用；涉及
specialise	[ˈspeʃəlaɪz] v. 专门研究，专攻；专用于，使适应特殊目的
twist	|
maintain	[meɪnˈteɪn] vt. 维持，保持；维修，保养；坚持，主张；赡养，负担
cease	[siːs] v. 停止，终止
dump	|
stale	[steɪl] a. 不新鲜的；陈腐的
legitimize	[lɪ'dʒɪtəmaɪz] vt. 使合法；赋予合法权利
intelligent	[ɪnˈtelɪdʒənt] a. 聪明的，理智的
challenge	|
imitation	[ˏɪmɪˈteɪʃn] n. 模仿；仿造；仿制品，假货，赝品
distort	[dɪˈstɔːt] vt. 扭曲；曲解；变形
canteen	[kænˈtiːn] n. 餐厅，食堂
smart	[smɑːt] a. 漂亮的，时髦的；高明的
trace	|
responsible	[rɪˈspɔnsəbl] a. 有责任感的；可靠的
petrol	[ˈpetrəl] n. 汽油
eliminate	[ɪˈlɪmɪneɪt] vt. 消灭，消除；淘汰
particular	|
vomit	|
apparatus	[ˏæpəˈreɪtəs] n. 器械，器具，仪器；机构，组织
extinguisher	[ɪkˈstɪŋgwɪʃə] n. 灭火器；灭火者
overestimate	|
spectrum	[ˈspektrəm] n. 谱，光谱，频谱；范围，幅度
revegetate	[ri:'vedʒɪteɪt] v. 再生长，再植
asset	[ˈæset] n. 财产；优点
excavate	[ˈekskəveɪt] vt. 挖掘，开凿
bully	|
promise	[ˈprɔmɪs] n./v. 允诺，保证；预兆，预示
monopoly	[məˈnɔpəlɪ] n. 垄断，专卖；垄断商品，专卖商品
prohibit	[prəˈhɪbɪt] v. 禁止，阻止
versus	[ˈvɜːsəs] prep. 与……相对，对抗
silt	|
inundate	[ˈɪnʌndeɪt] vt. 淹没，泛滥的；使不胜负荷，使应接不暇
meadow	[ˈmedəu] n. 草地
prescribe	[prɪˈskraɪb] v. 开处方，开药；规定，指示
favourite	|
aggravation	[ˌæɡrə'veɪʃn] n. 加重；恶化；愤怒，恼怒
doom	|
counsellor	[ˈkaunsələ(r)] n. 顾问，辅导顾问
self-esteem	[ˏself ɪˈstiːm] n. 自尊；自负
elbow	[ˈelbəu] n. 肘；（衣服的）肘部
foreseeable	[fɔ:ˈsi:əbl] a. 可预知的，能预测的
modernism	[ˈmɔdənɪzəm] n. 现代主义
realistic	[ˌri:əˈlɪstɪk] a. 现实（主义的），实际的；恰如其分的；逼真的
association	[əˏsəusɪˈeɪʃn] n. 协会
emotional	[ɪˈməʊʃənl] a. 感情（上）的，情绪（上）的；引起情感的，表示情感的；情绪激动的，易动感情的
actual	[ˈæktʃuəl] a. 实际的；真实的
disclose	[dɪsˈkləuz] vt. 揭露；透露；公开
blend	|
unload	[ˏʌnˈləud] v. 从……卸下货物；摆脱
barge	|
stark	[stɑːk] a. 光秃秃的，赤裸的；荒凉的；完全的
unbiased	[ʌnˈbaɪəst] a. 公正的，没有偏见的
magma	[ˈmægmə] n. 岩浆
application	[ˏæplɪˈkeɪʃn] n. 请求，申请（书，表）；应用，运用；施用，敷用
detect	[dɪˈtekt] vt. 发现，察觉；侦查，探测
gloss	|
intervention	[ˌɪntə'venʃn] n. 干涉，干预，介入
parcel	[ˈpɑːsl] n. 包裹
couple	|
locate	[ləuˈkeɪt] vt. 找到；位于；使坐落于；把……设置在
clockwise	[ˈklɒkwaɪz] a./ad. 顺时针方向的/地
supply	|
arboreal	[ɑːˈbɔːrɪəl] a. 树木的；栖于树木的
influenza	[ˏɪnfluˈenzə] n. 流行性感冒
socialise	[ˈsəuʃəlaɪz] v. （同他人）来往，交往，交际；使（某人）适应社会生活
popularize	['pɒpjələraɪz] vt. 宣扬，宣传，推广；使普及，使通俗化
behave	[bɪˈheɪv] v. 表现；（机器等）运转；（事物）起作用；表现得体；使检点
obscene	[əbˈsiːn] a. 淫秽的，猥亵的，下流的；可憎的，可恶的；（数量）大得惊人的，骇人听闻的
undoubtedly	[ʌn'daʊtɪdlɪ] ad. 毋庸置疑地，确凿地
midst	[mɪdst] n. 中间
understanding	|
reservation	[ˏrezəˈveɪʃn] n. 保留意见，存疑；预定，预订
private	[ˈpraɪvɪt] a. 私人的；私下的；私立的
hitherto	[ˏhɪðəˈtuː] ad. 到目前为止，迄今
absent	[ˈæbsənt] a. 不在场的；心不在焉的
succession	[səkˈseʃn] n. 连续；接替，继承
biography	[baɪˈɔgrəfɪ] n. 传记
cite	[saɪt] vt. 引用；引证
perquisite	[ˈpɜːkwɪzɪt] n. 利益；特权
advice	[ədˈvaɪs] n. 劝告，忠告；建议，（医生等的）意见
hallowed	[ˈhæləʊd] a. 受崇敬的；神圣（化）的
fund	|
fascinate	[ˈfæsɪneɪt] v. 强烈地吸引，使着迷
bureau	[ˈbjuərəu] n. 办公室；机构；局；处；所
rude	[ruːd] a. 粗鲁的；粗糙的
blanket	[ˈblæŋkɪt] n. 毯子；厚的覆盖物
predict	[prɪˈdɪkt] v. 预言；预告
swap	[swɔp] v./n. 交换
bid	[bɪd] n./v. 出价；投标
scarce	[skeəs] a. 缺乏的，不足的；稀少的，罕见的
percentage	[pəˈsentɪdʒ] n. 百分比，百分率
flexible	[ˈfleksəbl] a. 易弯曲的；柔韧的；灵活的
inborn	[ˏɪnˈbɔːn] a. 天生的，先天的，天赋的
topple	[ˈtɔpl] v. 倒塌，倒下；打倒，推翻
opulent	[ˈɔpjulənt] a. 豪华的，华丽的，富裕的；丰富的，丰饶的
administrative	__adminstrative__ [ədˈmɪnɪstrətɪv] a. 管理的，行政的
entwine	[ɪnˈtwaɪn] vt. 使缠住，使盘绕
destiny	[ˈdestɪnɪ] n. 命运，定数
adapt	[əˈdæpt] v. 使适合；改编；适应
foreland	[ˈfɔːlənd] n. 前沿地；岬角
tablet	[ˈtæblɪt] n. 药片
threshold	[ˈθreʃhəuld] n. 入门，门槛；界限；开端，起点
referee	|
impair	[ɪmˈpeə(r)] vt. 损害；削弱
flora	[ˈflɔːrə] n. （某地区或时期的）一切植物，植物群
installment	__intallment__ [ɪn'stɔ:lmənt] n. 分期付款；（连载或连播的）一集
discrepancy	[dɪˈskrepənsɪ] n. 不同；矛盾
steam	|
crocodile	[ˈkrɔkədaɪl] n. 鳄鱼；鳄鱼皮
counterproductive	[ˌkaʊntəprəˈdʌktɪv] a. 产生相反效果的，适得其反的
fraught	[frɔːt] a. 充满……的；担心的，烦恼的
audio	[ˈɔ:diəʊ] a. 听觉的；声音的
slump	|
segment	[ˈsegmənt] n. 片段；部分；节；线段；（橘子等的）瓣
depict	[dɪˈpɪkt] vt. 描绘，描述
constitute	[ˈkɔnstɪtjuːt] v. 组成；构成；设立，成立
notable	|
blame	[bleɪm] vt. 责怪，责备
accountant	[əˈkauntənt] n. 会计师
vulnerable	__vulnerabel__ [ˈvʌlnərəbl] a. 易受攻击的，易受伤的
apparent	[əˈpærənt] a. 显然的；表面上的
for-the-sake-of	for the sake of 为了
understandable	[ˌʌndəˈstændəbl] a. 可以理解的，能懂的；可同情的
extol	[ɪkˈstəul] vt. 赞颂，赞美，颂扬
requisition	[ˏrekwɪˈzɪʃn] n./vt. 正式要求；征用
aspect	[ˈæspekt] n. 方面；（建筑物的）朝向，方向；外貌，外观样子
surface	|
antiseptic	|
background	[ˈbækgraund] n. 背景；经历；后台；不重要或不引人注目的地方
chunk	[tʃʌŋk] n. 大块；相当大的部分（或数量）
smother	[ˈsmʌðə(r)] v. 厚厚的覆盖；（使）窒息；把（火）闷熄
disharmony	[dɪsˈhɑːmənɪ] n. 不一致；不和谐
intensity	[ɪn'tensətɪ] n. 强烈，剧烈；强度
senior	|
skew	|
biological	[ˏbaɪəˈlɔdʒɪkl] a. 生物的；生物学的，有关生物学的
depend	[dɪˈpend] vi. 依靠，依赖；信赖，相信；决定于，视……而定
statistically	[stə'tɪstɪklɪ] ad. 统计上地
camouflage	[ˈkæməflɑːʒ] v./n. 掩饰，伪装
detective	|
regional	['rɪːdʒənl] a. 局部范围的；地方（性）的，区域性的；全地区的，整个地区的
sanctuary	[ˈsæŋktʃuərɪ] n. 圣堂，圣殿，圣坛；圣地；庇护所，避难所；禁猎区，动物保护区
pliable	[ˈplaɪəbl] a. （指人或思想）容易受影响的；顺从的；易弯的，柔韧的
column	[ˈkɔləm] n. 柱；柱状物；专栏（文章），栏目
escalate	[ˈeskəleɪt] v. （使）逐步增长或发展，（使）逐步升级
impossible	[ɪmˈpɔsəbl] a. 不可能的，办不到的
disastrous	[dɪˈzɑ:strəs] a. 损失惨重的，灾难性的；极坏的
whistle	|
meagre	[ˈmiːgə(r)] a. 少量的，粗劣的
reference	[ˈrefərəns] n. 参考，参考书目；提及，涉及；证明书（或人）；介绍（人）
continually	[kən'tɪnjʊəlɪ] ad. 连续地，持续地
compassionate	[kəm'pæʃənət] a. 有同情心的，表示怜悯的
additional	[əˈdɪʃənl] a. 附加的；追加的
pest	[pest] n. 害虫
sticky	[ˈstɪkɪ] a. 黏性的；（天气）湿热的
implication	[ˏɪmplɪˈkeɪʃn] n. 含意；暗示，暗指；卷入，牵连
complain	[kəmˈpleɪn] v. 抱怨；投诉
infrastructure	['ɪnfrəstrʌktʃə(r)] n. 基础结构，基础设施
technician	[tekˈnɪʃn] n. 技术员，技师
desperate	[ˈdespərət] a. 绝望的；拼命的，不顾一切的；极度渴望的；危急的
sanitation	[ˏsænɪˈteɪʃn] n. （公共）卫生，卫生设施
plot	[plɔt] n. 情节；阴谋；小块土地
revolution	____ [ˏrevəˈluːʃn] n. 革命；巨变，大变革
numerous	[ˈnjuːmərəs] a. 众多的
continental	[ˌkɒntɪ'nentl] a. 欧洲大陆的；大陆性的  n. 欧洲大陆人
compel	[kəmˈpel] vt. 强迫
manoeuvre	|
glitter	[ˈglɪtə(r)] n./vi. 闪光
inventive	[ɪnˈventɪv] a. 发明的，创造的；善于发明创造的
phenomenon	[fəˈnɔmɪnən] n. 现象，迹象；非凡的人（或事物）
spade	[speɪd] n. 铁锹
pamphlet	[ˈpæmflət] n. 小册子
compensate	[ˈkɔmpenseɪt] v. 补偿，赔偿；弥补
specify	[ˈspesɪfaɪ] v. 指定；详细说明
terrain	[təˈreɪn] n. 地形，地势
deplete	[dɪˈpliːt] vt. 倒空；（使）枯竭；消耗
elevate	[ˈelɪveɪt] vt. 提升……的职位；举起；使更有修养
considerable	[kənˈsɪdərəbl] a. 相当大（或多）的，可观的；值得考虑的，重要的
alluvial	|
suffer	[ˈsʌfə(r)] v. 遭受，忍受；忍耐；容许；患病；受损失
workforce	[ˈwɜ:kˌfɔ:s] n. 受雇的或现有的工作人员总数；劳动人口
crystallize	[ˈkrɪstəlaɪz] v. （使）结晶；（使）变明确
astound	[əˈstaund] v. （使）震惊
trap	|
degrade	[dɪˈgreɪd] v. （使）降级；（使）堕落；（使）降解；（使）退化
former	|
decay	|
transparent	[trænsˈprənt] a. 透明的；清澈的；明显的；易懂的
judgment	['dʒʌdʒmənt] n. 意见；审判；判断（力）
romance	[rəuˈmæns] n. 恋爱；浪漫爱情；爱情小说，传奇故事
carry	|
suffice	[səˈfaɪs] v. （使）满足，（使）满意；足够
semantic	[sɪˈmæntɪk] a. 语义的
barbecue	[ˈbɑːbɪkjuː] n. 金属烤肉架；烧烤野餐
acupuncture	[ˈækjupʌŋktʃə(r)] n. 针刺疗法，针灸
track	|
tillable	__tilable__ ['tɪləbl] a. 适宜耕种的，可耕种的
siesta	[sɪˈestə] n. 午睡，午休
curiosity	[ˏkjuərɪˈɔsətɪ] n. 好奇，好奇心；稀奇或罕见的事物或人，古玩
abolish	[əˈbɔlɪʃ] vt. 废止，废除
cafeteria	[ˏkæfəˈtɪərɪə] n. 自助餐馆；自助食堂
keystone	['ki:stəʊn] n. 拱顶石；（计划，论据等的）基础，主旨
lead	|
intestine	[ɪnˈtestɪn] n.[解]肠
pregnancy	['preɡnənsɪ] n. 怀孕；怀孕期
odd	[ɔd] a. 奇特的；临时的；奇数的
essence	[ˈesns] n. 本质；精髓
campfire	[ˈkæmpfaɪə(r)]] n. 营火
jeopardise	[ˈdʒepədaɪz] vt. 危害，使受危困
ignorance	[ˈɪgnərəns] n. 无知，愚昧；不知道
guilty	['ɡɪltɪ] a. 内疚的；有罪的
compound	|
flicker	[ˈflɪkə(r)] n./vi. 闪烁；一闪而过
promote	[prəˈməut] vt. 促进；提升；促销
supplement	|
chain	|
faith	[feɪθ] n. 信任，信用；信仰，信条
timber	[ˈtɪmbə(r)] n. 木材，木料；栋木，大梁
relation	[rɪˈleɪʃn] n. 关系，联系；亲属，亲戚
stationery	[ˈsteɪʃənri] n. 文具
angle	|
illuminate	__illuminant__ [ɪˈluːmɪneɪt] vt. 照亮；阐明，解释；启发
unaware	[ˏʌnəˈweə(r)] a. 未意识到的
relocate	[ˏriːləuˈkeɪt] v. 重新安置，（使）搬迁，迁移
entrepreneur	__entreprenneur__ [ˏɔntrəprəˈnɜː(r)] n. 企业家；承包人
hereditary	[hɪˈredɪtrɪ] a. （尤指疾病）遗传的，遗传性的；可继承的，世袭的
female	|
dystrophy	[ˈdɪstrəfɪ] n. 营养障碍；营养不良
develop	[dɪˈveləp] v. 发展；生长，形成；开发
remain	|
detrimental	[ˌdetrɪˈmentl] a. 不利的，有害的
nutrient	[ˈnjuːtrɪənt] n. 滋养物，营养品
characteristic	|
integrate	[ˈɪntɪgreɪt] v. （使）合并，（使）成为一体
exotic	[ɪgˈzɔtɪk] a. 外来的；奇异的；醒目的，吸引人的
expiry	[ɪkˈspaɪərɪ] n. 满期，终结
source	[sɔːs] n. 来源，出处；（河的）源头，发源地；根源，起源
massive	[ˈmæsɪv] a. 大而重的，厚实的，粗大的；大量的，大规模的
semester	[sɪˈmestə(r)] n. 学期
general	|
ounce	[auns] n. 盎司
surround	[səˈraund] vt. 围绕；包围
discerning	[dɪˈsɜ:nɪŋ] a. 有识别力的，眼光敏锐的
managerial	[ˌmænəˈdʒɪəriəl] a. 经理的；管理的，经营的
larva	[ˈlɑːvə] n. [pl. larvae] 幼虫，幼体
transaction	[trænˈzækʃn] n. 办理；处理；交易，业务；[pl.] 会报，学报
critical	[ˈkrɪtɪkl] a. 批评的，评论的；危急的，紧要的；临界的；挑剔的
dean	[diːn] n. （基督教的）教长；（大学的）院长、系主任
modify	[ˈmɔdɪfaɪ] vt. 更改，修改；（语法上）修改
sheer	[ʃɪə(r)] a. 十足的；纯粹的；陡峭的
doctorate	['dɒktərɪt] n. 博士学位
mundane	[mʌnˈdeɪn] a. 世界的；世俗的，现世的；平淡的
aggravate	[ˈægrəveɪt] vt. 恶化，加重，加剧
stir	[stɜː(r)] v./n. 搅动；摇动；激动
compatible	[kəmˈpætəbl] a. 兼容的；合得来的
tempt	[tempt] vt. 引诱；吸引
conservative	|
indolent	[ˈɪndələnt] a. 懒惰的，倦怠的；不活跃的，无行动的
cancel	[ˈkænsl] v. 取消，废除；抵消，对消；删去，划掉
booth	[buːð] n. （隔开的）小房间；公用电话亭；售货棚
enjoyable	[ɪnˈdʒɔɪəbl] a. 令人愉快的，使人快乐的
conviction	__convinction__ [kənˈvɪkʃn] n. 定罪；坚信，确信
arcade	[ɑːˈkeɪd] n. 拱廊，有拱廊的街道
digest	|
scratch	|
incongruous	[ɪnˈkɔŋgruəs] a. 不协调的，不一致的；不适宜的
stagnate	[stægˈneɪt] v. （使）停滞；不发展
indication	[ˌɪndɪˈkeɪʃn] n. 指示，象征
scatter	[ˈskætə(r)] v. （使人或动物）散开，驱散；撒；撒播
confirm	[kənˈfɜːm] vt. 证实，确定；肯定；批准，使有效
earthquake	[ˈɜːθkweɪk] n. 地震
tangibly	['tændʒəblɪ] ad. 可触摸地；可感知地；有形地
mixture	[ˈmɪkstʃə(r)] n. 混合（物）
shrug	[ʃrʌg] n./v. 耸肩
knob	[nɔb] n. 球形把手；（机器等）旋钮
roll-film	__roll__  __film__ 胶卷
lunar	[ˈluːnə(r)] a. 月的；月亮的
witness	|
slouch	[slautʃ] v. 懒散地站（或坐、走）；低头垂肩地站（或坐、走）
compare	[kəmˈpeə(r)] v. 比较；对比
gorgeous	[ˈgɔːdʒəs] a. 华丽的；极好的
option	[ˈɔpʃn] n. 选择（权）；（供）选择的物（或人）；选课
stare	[steə(r)] n./vi. 盯
standpoint	[ˈstændpɔɪnt] n. 立场；观点
particle	[ˈpɑːtɪkl] n. 极少量；微粒
native	|
consumer	[kənˈsjuːmə(r)] n. 消费者；用户
bulb	[bʌlb] n. 灯泡
audition	[ɔːˈdɪʃn] n. 试演；试听，试音
relentless	[rɪˈlentləs] a. 无情的，残酷的
anecdote	[ˈænɪkdəut] n. 短故事；趣闻，轶事
flat	|
extrovert	[ˈekstrəvɜːt] n. 性格外向的人；爱交际的人
oversee	[ˏəuvəˈsiː] vt. 监督，监视（某人或某物）；俯瞰，眺望
crack	|
participate	[pɑːˈtɪsɪpeɪt] vi. 参加，参与
exhibit	|
laundry	__launtry__ [ˈlɔːndrɪ] n. 洗衣房；待洗衣服
remove	|
scheme	|
motive	[ˈməutɪv] n. 动机，目的
inviolable	[ɪnˈvaɪələbl] a. 不可侵犯的，不容亵渎的，不容破坏的
deserve	[dɪˈzɜːv] v. 应得；值得
adjunct	[ˈædʒʌŋkt] n. 附属物，附件；附加语，修饰语
impoverish	[ɪmˈpɔvərɪʃ] vt. 使贫困；使枯竭，使贫瘠
stitch	|
grope	[grəup] v. （暗中）摸索
counterpart	[ˈkauntəpɑːt] n. 与对方地位相当的人；配对物；副本
irrational	|
reunion	[ˏriːˈjuːnɪən] n. 重聚，团聚；（久别后的）聚会，联谊活动
workaholic	[ˏwɜːkəˈhɔlɪk] n. 工作狂
weakness	[ˈwi:knəs] n. 虚弱；缺点；偏好，嗜好
cholesterol	[kəˈlestərɔl] n. 胆固醇
suppose	[səˈpəuz] v. 假想，假定，猜想，推测；[用于祈使句] 假定，让；[常用于被动语态] 期望做（某事），认为应该做（某事）
modification	[ˌmɒdɪfɪˈkeɪʃn] n. 修改，改正
wealthy	['welθɪ] a. 富的，富裕的；充裕的
regularity	[ˌregjuˈlærəti] n. 规律性，规则性；整齐，匀称
ecology	[iːˈkɔlədʒɪ] n. 生态，生态学；生态环境
layer	[ˈleɪə(r)] n. 层，层次
sympathetic	[ˏsɪmpəˈθetɪk] a. 同情的，体谅的；赞同的，支持的；和谐的
legislative	|
conjunction	[kənˈdʒʌŋkʃn] n. 连接；连词
epitomise	[ɪˈpɪtəmaɪz] vt. 集中体现；概括
era	[ˈɪərə] n. 纪元；时代
comparatively	[kəmˈpærətɪvli] ad. 相对地；比较地
inaugurate	[ɪˈnɔːgjureɪt] vt. 开始，开创；为……举行就职典礼；为……举行开幕式；为……举行落成仪式
propagate	[ˈprɔpəgeɪt] v. 繁殖，增殖；传播，宣传，使普及
kit	|
prosperous	[ˈprɔspərəs] a. 繁荣的，兴旺的；成功的
profile	|
terminal	|
virus	[ˈvaɪərəs] n. 病毒
commodity	[kəˈmɔdətɪ] n. 商品，货物；日用品
contract	|
afflict	[əˈflɪkt] vt. 使苦恼；折磨
sulphuric-acid	__sulphuric__ __acid__ [sʌlˌfjʊərɪk ˈæsɪd] 硫酸
justify	[ˈdʒʌstɪfaɪ] v. 证明……为正当的；为……辩护
populate	[ˈpɔpjuleɪt] vt. （大批地）居住于，生活于
bring-out	__bring__  __out__[briŋ aut] 出版；激起；鼓励
beverage	[ˈbevərɪdʒ] n. 饮料
confine	|
in-accordance-with	in accordance with 按照，依据
retain	[rɪˈteɪn] vt. 保留；保持
force	|
core	|
contradict	[ˏkɔntrəˈdɪkt] v. 反驳，驳斥；与……发生矛盾；相抵触
rectangle	[ˈrektæŋgl] n. 长方形，矩形
asthma	[ˈæsmə] n. 哮喘症
acoustic	[əˈkuːstɪk] a. 原声的；声音（学）的；听觉的
recognition	[ˏrekəgˈnɪʃn] n. 识别；认出；承认，确认，认可；赏识，表彰
churn	|
mechanic	[mɪˈkænɪk] n. 机修工；[-s] 力学，机械学
mainstream	|
encompass	[ɪnˈkʌmpəs] vt. 包含；包围；环绕
insane	[ɪnˈseɪn] a. 蠢极的，荒唐的；（患）精神病的，精神失常的，疯狂的
manifest	|
taunt	|
escalator	[ˈeskəleɪtə(r)] n. <美> 自动扶梯
element	__elememt__ [ˈelɪmənt] n. 要素；元素； [the -s] 基本原理
humble	[ˈhʌmbl] a. 谦逊的，谦虚的；地位（或身份）低下的，卑贱的；简陋的，低劣的  vt. 使谦恭；使卑下；贬低
respect	|
sceptical	[ˈskeptɪkl] a. 怀疑的，猜疑的
pitch	|
shuttle	[ˈʃʌtl] n. 航天飞机
embody	[ɪmˈbɔdɪ] vt. （作品等）表达，体现；具体表现，使具体化；包括，包含
concern	|
radiate	[ˈreɪdɪeɪt] v. 发光；发热；辐射
striking	[ˈstraɪkɪŋ] a. 显著的，惹人注目的
altitude	[ˈæltɪtjuːd] n. 海拔，高度；[pl.] 高地，高处
calm	|
design	|
delicate	[ˈdelɪkət] a. 纤细的；精巧的；微妙的
swell	[swel] v. 膨胀；增长，增强
regarding	[rɪˈgɑ:dɪŋ] prep. 关于
fracture	|
souvenir	[ˏsuːvəˈnɪə(r)] n. 纪念品，纪念物
board	[bɔːd] n. 板；委员会
circus	[ˈsɜːkəs] n. 马戏团；环形广场
axle	[ˈæksl] n. 车轴，轮轴
microbiology	[ˌmaɪkrəʊbaɪˈɒlədʒi] n. 微生物学
strand	[strænd] n. 股，缕；部分，方面
generous	[ˈdʒenərəs] a. 慷慨的；大量的
briefcase	[ˈbriːfkeɪs] n. 公文包
weapon	[ˈwepən] n. 武器，兵器
vocational	[vəʊˈkeɪʃənl] a. 职业的，业务的
anatomy	[əˈnætəmɪ] n. 解剖（学）；解剖结构
organ	[ˈɔːgən] n. 器官；（官方的）机构
authorise	__arthorise__ [ˈɔːθəraɪz] vt. 批准，认可；授权
hum	|
retailing	[ˈri:teɪlɪŋ] n. 零售业
limestone	['laɪmstəʊn] n. 石灰石，石灰岩
submerge	[səbˈmɜːdʒ] v. 浸没；潜入水中
partial	[ˈpɑːʃl] a. 部分的，不完全的；偏爱的，癖好的；偏向一方的，偏心的
bleak	[bliːk] a. 寒冷的，阴沉的，阴郁的，暗淡的；没有希望的，不乐观的；荒凉的；索然无味的
misjudge	[ˏmɪsˈdʒʌdʒ] vt. 判断错误
discretion	[dɪˈskreʃn] n. 判断力；谨慎，审慎；明智
beyond	[bɪˈjɔnd] prep. 在……较远的一边；超出；除……之外
excellent	[ˈeksələnt] a. 极好的；杰出的
heir	[eə(r)] n. 继承人
consequently	[ˈkɔnsikwəntli] ad. 因此，因而
insidious	[ɪnˈsɪdɪəs] a. 潜伏的，隐伏的
linguistic	[lɪŋˈgwɪstɪk] a. 语言的；语言学的
trench	|
molecule	[ˈmɔlɪkjuːl] n. 分子
cap	|
unparalleled	[ʌnˈpærəleld] a. 无双的，无比的，空前的
unregistered	['ʌn'redʒɪstəd] a. 未注册的
nursery	|
elicitation	[ɪˌlɪsɪ'teɪʃn] n. 引出，诱出
fertile	[ˈfɜːtaɪl] a. 肥沃的，多产的，富饶的；能繁殖的
starchy	['stɑ:tʃɪ] a. 含淀粉的
agile	__agile_ [ˈædʒaɪl] a. 敏捷的，灵活的，机敏的
deposit	|
steady	|
instrumental	[ˏɪnstruˈmentl] a. 有帮助的，起作用的；用乐器演奏的
property	[ˈprɔpətɪ] n. 财产，所有物；性质，特性；房产，地产
assimilation	[əˌsɪməˈleɪʃn] n. 吸收；（被）吸收和同化的过程
purify	[ˈpjuərɪfaɪ] vt. 使洁净，使纯洁，净化；提纯，精炼
stance	[stæns] n. 姿势；观点，立场
conversely	[ˈkɒnvɜ:sli] ad. 相反地，颠倒地
disable	[dɪsˈeɪbl] vt. 使丧失能力，使伤残；使不能正常运转，使无效
exclude	[ɪkˈskluːd] vt. 把……排斥在外；将（某物）排除，不包括
memorise	[ˈmeməraɪz] vt. 记住，熟记
cast	|
exterior	|
strengthen	['strŋθn] vt. 加强，巩固
recycle	[ˏriːˈsaɪkl] v. 回收利用
mechanical	[mɪˈkænɪkl] a. 机械的，机械制造的；呆板的；习惯性的；体力的
dismantle	[dɪsˈmæntl] vt. 拆除；废除，取消
sift	[sɪft] v. 细查；筛；过滤
initiate	|
promising	['prɒmɪsɪŋ] a. 有希望的；有前途的
sociable	[ˈsəuʃəbl] a. 友善的，友好的；好交际的，合群的
sector	[ˈsektə(r)] n. 部分，部门；防御地段，防区；扇形
journal	[ˈdʒɜːnl] ｎ. 杂志；日报；日志
coordinator	__coodinator__ [kəʊ'ɔ:dɪneɪtə] n. 协调者
junction	[ˈdʒʌŋkʃn] n. 连接；联结点；交叉路口
migrant	[ˈmaɪgrənt] n. 移居者，移民；迁移动物，候鸟
ripe	[raɪp] a. （水果或庄稼）成熟的；时机成熟的
altruistic	[ˌæltrʊ'ɪstɪk] a. 无私的，为他人着想的
trivial	[ˈtrɪvɪəl] a. 无价值的，琐屑的；平庸的，普通的
guidance	[ˈgaɪdns] n. 指引，指导
loan	[ləun] n./vt. 贷款，借
livestock	[ˈlaɪvstɔk] n. <总称> 家畜，牲畜
contempt	[kənˈtempt] n. 轻视，鄙视，不尊重；蔑视
bound	[baund] a. 负有义务的；一定的，必然的
recipient	[rɪˈsɪpɪənt] n. 接受者
conventional	[kənˈvenʃənl] a. 普通的，习惯的；常规的，因循守旧的，传统的
conditioner	[kənˈdɪʃənə(r)] n. 护发素，护发剂；调节物；调节器，调节装置
roast	|
familiarise	[fəˈmɪlɪəraɪz] vt. 使熟悉，使通晓；使家喻户晓
vegetarian	|
demographic	[ˌdemə'ɡræfɪk] a. 人口统计学的；人口的
review	|
notoriety	[ˌnəʊtəˈraɪəti] n. 声名狼藉，臭名昭著
comprise	[kəmˈpraɪz] vt. 包含；由……组成
granite	[ˈgrænɪt] n. 花岗岩，花岗石
warrant	|
dot	|
microcosm	[ˈmaɪkrəukɔzəm] n. 微观世界；缩影
mild	[maɪld] a. 温柔的；温和的；轻微的
drought	[draut] n. 干旱，旱灾
crush	[krʌʃ] vt. 碾碎；压服，压垮；镇压，制服；压碎，压坏
tremendous	[trɪˈmendəs] a. 极大的，巨大的；非常的，惊人的
link	|
irritate	[ˈɪrɪteɪt] vt. 使烦躁；使疼痛；刺激
attractive	[əˈtræktɪv] a. 吸引的，有吸引力的；引起注意的
extrusion	[ɪk'stru:ʒn] n. 挤出，推出，挤压
plateau	[ˈplætəu] n. 高原；（上升后的）稳定时期（或状态）
turbine	[ˈtɜːbaɪn] n. 涡轮机，汽轮机
participant	[pɑ:ˈtɪsɪpənt] n. 参加者，参与者
perform	[pəˈfɔːm] v. 履行，执行，完成；表演，演出；（机器）运作
pollution	[pəˈlu:ʃn] n. 污染，污染物；玷污
punctual	[ˈpʌŋktʃuəl] a. 守时的；准时的
jaw	[dʒɔː] n. 颌
distribution	[ˌdɪstrɪ'bju:ʃn] n. 分发，分配；配给物；散布，分布
seduce	[sɪˈdjuːs] vt. 勾引，引诱；诱使，唆使
arrange	[əˈreɪndʒ] v. 安排；排列
journalist	[ˈdʒɜ:nəlɪst] n. 新闻工作者，新闻记者
susceptible	[səˈseptəbl] a. 易受影响的，易受伤害的；易受感染的；（人）敏感的，易动感情的；能经受……的，容许……的
immense	[ɪˈmens] a. 巨大的，广大的
triangle	[ˈtraɪæŋgl] n. 三角（形）
sole	|
straw	[strɔː] n. 稻草；吸管
diagram	[ˈdaɪəgræm] n. 图解，图表
clash	|
demolish	[dɪˈmɔlɪʃ] vt. 破坏；拆除；驳倒（论点等），推翻
intend	[ɪnˈtend] v. 想要，打算
skull	[skʌl] n. 颅骨；脑袋
seal	|
leak	|
cosset	|
significance	[sɪgˈnɪfɪkəns] n. 重要性，意义
probation	[prəˈbeɪʃn] n. 缓刑（制）；（对人的）试用；试用期
metaphor	[ˈmetəfə(r)] n. 隐喻，暗喻
refectory	[rɪˈfektrɪ] n. （学院）餐厅，食堂
restrain	[rɪˈstreɪn] vt. 阻止；抑制
ambition	[æmˈbɪʃn] n. 雄心，抱负；野心
inflation	[ɪn'fleɪʃn] n. 通货膨胀
surpass	[səˈpɑːs] v. 超过，超越，优于，胜过；超过……的界限，非……所能办到（或理解）
vicious	[ˈvɪʃəs] a. 罪恶的，邪恶的；残酷的；残忍的；凶猛的；恶性的
vary	[ˈveərɪ] v. 改变；（使）多样化；变化；不同
economic	[ˏiːkəˈnɔmɪk] a. 经济的；经济上的，经济学的
alcohol	[ˈælkəhɔl] n. 含酒精饮料，酒；酒精
baron	[ˈbærən] n. 贵族；男爵
correspond	[ˏkɔrɪˈspɔnd] vi. 相一致，符合；通信；相当于，相应
hawk	[hɔːk] n. 鹰，隼
binoculars	[bɪˈnɔkjuləz] n. 双筒望远镜
terminology	[ˏtɜːmɪˈnɔlədʒɪ] n. （某学科的）专门用语；术语
block	|
flaw	[flɔː] n. 缺点；瑕疵
pathology	[pəˈθɔlədʒɪ] n. 病理学；病变
efficiency	[ɪ'fɪʃnsɪ] n. 效率；功效，效能
expose	[ɪkˈspəuz] vt. 使暴露，揭露
event	[ɪˈvent] n. 事件；比赛项目
maximum	|
discriminate	__dicriminate__ [dɪˈskrɪmɪneɪt] v. 区别；歧视
comprehension	[ˏkɔmprɪˈhenʃn] n. 理解；理解力
examine	[ɪgˈzæmɪn] vt. 检查；调查，研究；测验
applicant	[ˈæplɪkənt] n. 申请人
studio	[ˈstjuːdɪəu] n. 工作室；摄影室；练习室
operational	[ˌɒpəˈreɪʃənl] a. 运转的；操作的；运营的，业务的
concert	[ˈkɔnsət] n. 音乐会，演奏会
inventory	[ˈɪnvəntrɪ] n. 目录；存货
dissemination	[dɪˌsemɪ'neɪʃn] n. 散布，传播
shortage	__shotage__ [ˈʃɔːtɪdʒ] n. 不足，缺少
limited	['lɪmɪtɪd] a. 有限的
mite	[maɪt] n. 极小量；螨虫
indicate	[ˈɪndɪkeɪt] v. 标示，表示，表明；象征；暗示，示意
connect	[kəˈnekt] v. 连接，衔接；联合，关联；由……联想到；给……接通电话
attend	[əˈtend] v. 出席，参加；随同，陪同；专心，注意
strategist	[ˈstrætədʒɪst] n. 战略家
condensation	__condensatioin__ [ˏkɔndenˈseɪʃn] n. 浓缩，凝结
correspondence	[ˌkɒrəˈspɒndəns] n. 通信，信件；符合，一致；对应
arthritis	[ɑːˈθraɪtɪs] n. 关节炎
flint	[flɪnt] n. 火石，打火石
tackle	_tackle___ [ˈtækl] v. 对付，处理；向某人提起（问题或困难情况）；（足球等比赛中）抢截，抢球
impulse	[ˈɪmpʌls] n. 冲动，突如其来的念头；刺激，驱使；脉冲
independent	|
ability	[əˈbɪlətɪ] n. 能力；本领；才能
pad	|
ambassador	[æmˈbæsədə(r)] n. 大使，使节
advantageous	[ˌædvənˈteɪdʒəs] a. 有利的
harridan	[ˈhærɪdən] n. 凶恶的老妇；老巫婆
theoretical	[ˏθɪəˈretɪkl] a. 理论（上）的
tribal	[ˈtraɪbl] a. 部落的，部族的；集团意识强的
reckon	[ˈrekən] v. 认为，估计；测算，测量；料想，指望
catalogue	|
bow	|
fatal	[ˈfeɪtl] a. 致命的；重大的；命中注定的；灾难性的
bore	|
laser	[ˈleɪzə(r)] n. 激光
cultural	[ˈkʌltʃərəl] a. 文化的，人文的
barrage	[ˈbærɑːʒ] n. 弹幕射击；火力网
legacy	[ˈlegəsɪ] n. 遗产，遗赠
carve	[kɑːv] v. 切；雕刻
equal	|
extensive	[ɪkˈstensɪv] a. 广大的，广阔的；广泛的
efficient	[ɪˈfɪʃnt] a. 有效的，效率高的；有能力的，能胜任的
series	[ˈsɪəriːz] n. 一系列，连续；丛书
wax	|
profound	[prəˈfaund] a. 深切的，深远的；知识渊博的，见解深刻的，深奥的
grill	|
adjacent	[əˈdʒeɪsnt] a. 邻近的，毗连的
express	|
collateral	[kəˈlætərəl] a. 并行的；间接的，附带的
cater	[ˈkeɪtə(r)] v. 提供饮食；迎合，满足需要（或欲望）
brew	[bruː] v. 酿造；冲泡；酝酿
edible	[ˈedəbl] a. 可食用的
transport	|
manipulative	__manipulatvie__ [mə'nɪpjələtɪv] a. 操纵别人的；老于世故的
overhead	|
simplistic	[sɪmˈplɪstɪk] a. 过分单纯化的，过分简单化的
attitude	[ˈætɪtjuːd] n. 态度，看法；姿势
gear	|
tolerate	[ˈtɔləreɪt] vt. 容忍，宽容；容许，承认
entertain	[ˏentəˈteɪn] v. （使）欢乐，（使）娱乐；招待
unblemished	[ʌnˈblemɪʃt] a. 无瑕疵的，完好的
rural	[ˈruərəl] a. 农村的，乡村的
remark	|
artefact	[ˈɑ:tɪfækt] n. 人工制品，手工艺品
content	|
account	|
utterance	[ˈʌtərəns] n. 用言语表达，讲话；话语，言语，言论
surgeon	[ˈsɜːdʒən] n. 外科医生
invoke	[ɪnˈvəuk] vt. 恳求，祈求；援用，援引；使用，应用
darkroom	[ˈdɑ:kru:m] n. 暗室
publicity	[pʌbˈlɪsətɪ] n. 宣传，宣扬；公众的注意，名声
ingredient	[ɪnˈgriːdɪənt] n. （混合物的）组成部分，成分；（烹调的）原料；（构成）要素，因素
catastrophic	[ˌkætə'strɒfɪk] a. 悲惨的；灾难性的
hamlet	[ˈhæmlɪt] n. 小村庄
rear	|
dismiss	[dɪsˈmɪs] v. 解雇，解散；驳回，不受理
schedule	|
preference	_preference___ [ˈprefrəns] n. 喜爱；偏爱的事物（或人）；优先
disturb	[dɪˈstɜːb] v. 扰乱；弄乱，打乱；打扰，使烦恼
decompose	[ˏdiːkəmˈpəuz] v. （使）分解，（使）腐烂
create	[kriːˈeɪt] vt. 创造，创作；产生
transcribe	[trænˈskraɪb] vt. 抄写，誊写；打印；转录
homogeneous	[ˏhɔməˈdʒiːnɪəs] a. 同种类的，由相同（或同类型）事物（或人）组成的
spectator	[spekˈteɪtə(r)] n. 观众；旁观者
crew	[kruː] n. 全体船员；工作人员；队，组
goal	[gəul] n. 球门；射门，进球得分；目标
merge	[mɜːdʒ] v. （使）结合
prolonged	[prəˈlɒŋd] a. 持久的，长期的
vulgar	[ˈvʌlgə(r)] a. 庸俗的，粗俗的，下流的，缺乏教养的；大众的，通俗的
atomic	[əˈtɔmɪk] a. 原子（能）的
reptile	[ˈreptaɪl] n. 爬行动物，爬虫类；卑鄙的人
render	[ˈrendə(r)] vt. 使得，致使；给予，以……回报；提供；呈报，递交；表达；表演；翻译
pedestrian	|
crust	[krʌst] n. 硬层，硬表面，地壳；（一片）面包皮
hospitable	[hɔˈspɪtəbl] a. 好客的，殷勤的，热情友好的；（气候、环境）宜人的；（对新思想等）易接受的，开通的
hug	[hʌg] n./v. （热烈的/地）拥抱
desire	[dɪˈzaɪə(r)] v./n. 想望，期望；要求
radius	[ˈreɪdɪəs] n. 半径；周围，范围
consult	[kənˈsʌlt] v. 请教；查阅；商议
embassy	[ˈembəsɪ] n. 大使馆；大使馆全体官员
suburb	[ˈsʌbɜːb] n. 郊区
unrealistic	[ˌʌnrɪəˈlɪstɪk] a. 不现实的，不切实际的
violate	[ˈvaɪəleɪt] vt. 违反，违犯，违背；亵渎，侵犯，干扰
corpus	[ˈkɔːpəs] n. 文集，文献，汇编；语料库
cereal	[ˈsɪərɪəl] n. 谷类植物；谷物；谷类食物
confirmation	__confimation__ [ˏkɔnfəˈmeɪʃn] n. 证实，确认；批准
hamper	|
afield	[əˈfiːld] ad. 在野外，在田中；在战场上；背井离乡地；到远方，在远处
violent	[ˈvaɪələnt] a. 暴力的；带有强烈感情的；猛烈的
disregard	|
destructive	[dɪˈstrʌktɪv] a. 破坏（性）的
assign	[əˈsaɪn] vt. 指派，分配；指定
embryo	[ˈembrɪəu] n. 胚，胚胎；事物的萌芽期
memorable	[ˈmemərəbl] a. 容易记住的；难忘的
suitably	[ˈsu:təbli] ad. 合适地，适宜地，相称地
mattress	[ˈmætrɪs] n. 床垫
orthodox	[ˈɔːθədɔks] a. 正统的，传统的
hurdle	|
departmental	[‚diːpɑːt'mentl] a. 部门的
breakdown	[ˈbreɪkdaun] n. 垮台，倒塌，破裂；（健康、精神等）衰竭，衰弱；（机器等的）损坏，故障；分类
profession	[prəˈfeʃn] n. 行业，职业；宣称，表白
statistics	[stəˈtɪstɪks] n. 统计数字，统计资料；统计学
linger	[ˈlɪŋgə(r)] vi. 继续逗留；缓慢消失
principal	|
utilise	[ˈjuːtəlaɪz] vt. 利用，运用
switch	|
slumber	|
similarly	['sɪmələlɪ] ad. 同样地，类似地
spiral	|
resist	[rɪˈzɪst] v. 抵抗；抗（病等）；耐（热等）
aspiration	[ˏæspəˈreɪʃn] n. 强烈的愿望；志向
farewell	[ˏfeəˈwel] n. 告别；欢送会
colour-blind	['kʌlə(r) blaɪnd] a. 色盲的
postgraduate	[ˏpəustˈgrædʒuət] n. 研究生
irritation	[‚ɪrɪ'teɪʃn] n. 激怒，恼怒；刺激物，恼人的事
reliance	[rɪˈlaɪəns] n. 依靠，依赖
circle	|
cooperate	[kəuˈɔpəreɪt] vi. 合作，协作
apart	|
extremely	[ɪkˈstri:mli] ad. 极端地；非常地
indifferent	[ɪnˈdɪfrənt] a. 冷漠的，不关心的
artery	[ˈɑːtərɪ] n. 动脉；干线，要道
stroke	|
terrestrial	[təˈrestrɪəl] a. 陆地的，陆生的，陆栖的；地球的
tickle	|
scenery	[ˈsiːnərɪ] n. 舞台布景；风景，景色
overrate	[ˏəuvəˈreɪt] vt. 对……评价过高，高估
blast	|
productivity	[ˏprɔdʌkˈtɪvətɪ] n. 生产力；生产率
trick	|
inhale	[ɪnˈheɪl] v. 吸（烟），吸气
hinterland	[ˈhɪntəlænd] n. 内地，腹地，内陆
inference	[ˈɪnfərəns] n. 推论；推断
disadvantage	[ˏdɪsədˈvɑːntɪdʒ] n. 缺点，不利
succumb	[səˈkʌm] vi. 屈服，屈从；（因……）死亡
ulterior	[ʌlˈtɪərɪə(r)] a. 较远的；不可告人的，隐秘的，秘密的
aridity	[ə'rɪdətɪ] n. 干旱；乏味
breakwater	[ˈbreɪkwɔːtə(r)] n. 防浪堤
consolidation	[kənˌsɒlɪ'deɪʃən] n. 合并；巩固
grimy	['ɡraɪmɪ] a. 积满污垢的，肮脏的
climate	[ˈklaɪmɪt] n. 气候；风气，思潮
eminent	[ˈemɪnənt] a. 杰出的，显赫的
provenance	[ˈprɔvənəns] n. 出处，起源
precision	[prɪˈsɪʒn] n. 准确，精确；精确度
reorient	[ˌri:'ɔ:rɪent] vt. 重新定位方位；重新定位；使适应
breakthrough	[ˈbreɪkθru:] n. 突破；重大进展
lateral	[ˈlætərəl] a. 侧面的，旁边的
formal	[ˈfɔːml] a. 正式的；正规的
damp	|
replicate	['replɪkeɪt] vt. 重复，复现或复制；再制造；再生
location	[ləuˈkeɪʃn] n. 位置，场所；（电影的）外景拍摄地
helix	[ˈhiːlɪks] n. 螺旋（形），螺旋结构
alley	[ˈælɪ] n. 小巷；胡同
organize	[ˈɔːgənaɪz] v. 组织，使有条理；成立
exhilaration	[ɪɡˌzɪlə'reɪʃn] n. 高兴；兴奋
addition	[əˈdɪʃn] n. 加，增加（物）
concrete	|
stem	|
cylinder	[ˈsɪlɪndə(r)] n. 圆柱体；圆筒；汽缸
status	[ˈsteɪtəs] n. 地位；身份；状况
factual	[ˈfæktʃuəl] a. 事实的；真实的，确凿的
duplicate	|
volcano	__valcono__ [vɔlˈkeɪnəu] n. 火山
corrupt	|
rigid	[ˈrɪdʒɪd] a. 严格的，死板的；刚硬的，僵硬的
foster	|
eligible	[ˈelɪdʒəbl] a. 符合条件的；合适的
nevertheless	|
swivel	|
adhere	[ədˈhɪə(r)] vi. 黏附；遵守；坚持
breeze	[briːz] n. 微风，和风
allure	[əˈluə(r)] n./v. 诱惑，吸引
embark	[ɪmˈbɑːk] v. （使）上船或飞机；（使）从事
spectacular	|
wire	[ˈwaɪə(r)] n. 金属丝；电线
transportation	[ˌtrænspɔ:ˈteɪʃn] n. 运输，运输系统，运输工具
delay	[dɪˈleɪ] n./v. 耽搁，延迟，延期，迟滞
consequence	[ˈkɔnsɪkwəns] n.[常pl.] 结果，影响；重要意义
ethereal	[ɪˈθɪərɪəl] a. 太空的；轻巧的
barren	[ˈbærən] a. （土地等）贫瘠的，荒芜的；不结果实的，不育的；无益的，无效果的
outline	|
furniture	[ˈfɜːnɪtʃə(r)] n. 家具
entrepreneurial	__entreprenurial__ [ˌɒntrəprə'nɜ:rɪəl] a. 创业的
banner	[ˈbænə(r)] n. 横幅；旗帜
thrifty	[ˈθrɪfti] a. 节俭的，节约的
stash	__stach__ [stæʃ] vt. 藏匿；贮藏
intrinsic	[ɪnˈtrɪnsɪk] a. 固有的，内在的；本质的
luggage	[ˈlʌgɪdʒ] n. 行李
gamble	[ˈgæmbl] v. 赌博，打赌；投机；冒险
adaptation	[ˌædæpˈteɪʃn] n. 适应；改编；改制物
frank	[fræŋk] a. 坦白的，直率的
pardon	|
luxuriant	[lʌgˈʒuərɪənt] a. 繁茂的；肥沃的；丰富的
acumen	[ˈækjumen] n. 敏锐；精明
notice-board	__notice__ __board__ 布告牌，公告牌
gullibly	['gʌləblɪ] ad. 轻信地，易受欺骗地
definition	[ˏdefɪˈnɪʃn] n. 定义，释义；清晰（度）
lax	[læks] a. 懒散的；松弛的，不严格的，马虎的
windscreen	[ˈwɪndskri:n] n. 挡风玻璃；风档
brilliant	__briliant__ [ˈbrɪlɪənt] a. 光辉灿烂的；卓越的，有才华的
genetic	|
velocity	[vɪˈlɔsətɪ] n. 速度，速率；迅速，快速
institution	_institution___ [ˏɪnstɪˈtjuːʃn] n. （行业）协会；机构；制度；习俗；团体；设立，制定
vision	[ˈvɪʒn] n. 想象力；视力，视觉；梦幻，幻觉
encode	[ɪnˈkəud] vt. 把（电文等）译成电码（或密码），把……编码
conduce	[kənˈdjuːs] v. 有益于，有助于；导致
appliance	[əˈplaɪəns] n. 用具，器具
gallop	[ˈgæləp] v./n. 奔驰，飞跑，飞驰
objective	|
excavation	[ˌekskəˈveɪʃn] n. 挖掘，发掘；出土文物
engrave	[ɪnˈgreɪv] vt. （在……上）雕刻；（使）铭记
quota	[ˈkwəutə] n. 定额，限额，配额
expedition	[ˏekspɪˈdɪʃn] n. 远征，探险，考察；（短途的）旅行，出行；远征队，探险队，考察队
vast	[vɑːst] a. 巨大的；大量的
headmaster	[ˌhedˈmɑ:stə(r)] n. （中小学）校长
compass	[ˈkʌmpəs] n. 罗盘，罗盘仪；界限，范围；[pl.] 圆规
eject	[ɪˈdʒekt] v. 弹出；喷出；驱逐，逐出
conservation	[ˏkɔnsəˈveɪʃn] n. 保存；保护
athlete	[ˈæθliːt] n. 运动员；体育家
baffle	|
accuracy	[ˈækjərəsɪ] n. 准确（性），精确（性）
subtle	[ˈsʌtl] a. 细微的，微妙的，难以捉摸的；隐约的；精巧的，巧妙的；诡秘的，狡诈的
incorporate	[ɪnˈkɔːpəreɪt] vt. 把……合并，纳入；包含，吸收
detour	|
interdependent	[ˏɪntədɪˈpendənt] a. 互相依赖的，互助的
adolescence	[ˏædəˈlesns] n. 青春，青春期
route	[ruːt; raut] n. 路线；路程
crown	[kraun] n. 王冠；花冠；齿冠
reinforcement	[ˌri:ɪn'fɔ:smənt] n. 增援，加强，加固
excursion	[ɪkˈskɜːʃn] n. 远足，短途旅游；[物] 偏移，漂移
almond	[ˈɑːmənd] n. 杏树；杏仁
wean	[wiːn] vt. （使）断奶，（使）戒掉
reclaim	[rɪˈkleɪm] vt. 纠正；要求归还，收回；开垦（土地）
prey	|
alleviate	[əˈliːvɪeɪt] vt. 减轻，缓解，缓和
bamboo	[bæmˈbuː] n. 竹子
entail	[ɪnˈteɪl] vt. 牵涉；需要
adverse	[ˈædvɜːs] a. 不利的，有害的
bungalow	[ˈbʌŋgələu] n. （带走廊的）平房
desert	|
achievement	[əˈtʃi:vmənt] n. 成就，成绩；达到，完成，实现
payable	[ˈpeɪəbl] a. 可支付的；应支付的
preferable	[ˈprefrəbl] a. 更可取的，更好的，更合意的
facade	[fəˈsɑːd] n. 正面；（虚伪的）外表
chest	[tʃest] n. 胸；金库，资金
storyline	[ˈstɔ:rilaɪn] n. 故事情节
detract	[dɪˈtrækt] v. 去掉，减损
inhabitant	[ɪnˈhæbɪtənt] n. 居民，住户，居住者；栖息的动物
resistant	[rɪˈzɪstənt] a. 抵抗的，有抵抗力的
split	|
fashion	[ˈfæʃn] n. 方式；流行款式；时装
innocent	[ˈɪnəsnt] a. 清白的；无害的；天真的
relevant	[ˈreləvənt] a. 有关的，相应的；适当的，中肯的；有重大意义的
oxygen	[ˈɔksɪdʒən] n. 氧，氧气
greasy	[ˈgriːsɪ] a. 多脂的；油滑的
cardiovascular	[ˌkɑ:diəʊˈvæskjələ(r)] a. 心血管的
gill	[gɪl] n. 鳃
stimulus	[ˈstɪmjuləs] n. 刺激（物），促进（因素）
emboss	[ɪmˈbɔs] vt. 使……凸出；压花（纹）
component	|
diesel	[ˈdiːzl] n. 柴油；柴油机；柴油车
incentive	[ɪnˈsentɪv] n. 刺激；激励
fuel	|
resilience	[rɪˈzɪliəns] n. 弹性，弹力；复原力；适应性；（指人）乐观的性情
bronchitis	[brɔŋˈkaɪtɪs] n.[医] 支气管炎
mortality	[mɔːˈtælətɪ] n. 死亡率
missile	[ˈmɪsaɪl] n. 发射物；导弹，飞弹
medium	|
badge	[bædʒ] n. 徽章；标记；象征
exile	|
sample	|
institute	|
congress	['kɒŋɡres] n. （代表）大会；（美国等国的）国会，议会
cautious	[ˈkɔːʃəs] a. 十分小心的，谨慎的
willing	[ˈwɪlɪŋ] a. 愿意的，乐意的
effect	|
dazzle	|
devise	[dɪˈvaɪz] vt. 设计，发明
extract	|
rekindle	[ˏriːˈkɪndl] vt. 重新点燃；使复苏
hierarchy	[ˈhaɪərɑːkɪ] n. 领导层；层次，等级
practically	[ˈpræktɪkli] ad. 几乎，简直；实际上
pulley	[ˈpulɪ] n. 滑轮；滑车
drum	[drʌm] n. 鼓，鼓状物
intact	[ɪnˈtækt] a. 完整无缺的；完好无损的
continuous	[kənˈtɪnjuəs] a. 连续的，不断的
revenue	[ˈrevənjuː] n. （尤指大宗的）收入；税收
inherent	[ɪnˈhɪərənt] a. 内在的；生来就有的
pathway	[ˈpɑ:θweɪ] n. 路径，途径
lenient	[ˈliːnɪənt] a. （执法时）宽大的，宽容的；厚道的，仁慈的
wrap	[ræp] v. 裹；包；缠绕
rival	|
defect	|
strain	[streɪn] v./n. 拉紧，绷紧；扭伤，拉伤；（使）过劳，（使）极度紧张
lecture	[ˈlektʃə(r)] n. 演讲，讲课
disdain	[dɪsˈdeɪn] v./n. 鄙视，蔑视
credibility	[ˌkredəˈbɪləti] n. 可信性，可靠性
identification	[aɪˌdentɪfɪˈkeɪʃn] n. 身份证明；识别，鉴定
engage	[ɪnˈgeɪdʒ] v. 吸引（某人的注意力等）；占用（某人的时间）；使从事于，使忙于；雇用，聘用；与（某人）交战；（指机器零件等）啮合，衔接
ministry	[ˈmɪnɪstrɪ] n. （政府的）部
agency	[ˈeɪdʒənsɪ] n. 机构；代理，代办
exploitative	[ɪkˈsplɔɪtətɪv] a. 开发的，利用的；剥削的
bypass	|
prohibitive	[prəˈhɪbətɪv] a. 禁止的，抑制的；令人望而却步的
excreta	[ɪkˈskriːtə] n. 排泄物
presumably	[prɪˈzju:məbli] ad. 推测起来，大概
dupe	|
nutritious	[njuˈtrɪʃəs] a. 有营养的，营养丰富的
flutter	[ˈflʌtə(r)] v. 振（翅），拍打（翅膀）；飘动，晃动；（快速而不规则地）跳动
barrel	[ˈbærəl] n. 桶，圆筒
poison	|
response	[rɪˈspɔns] n. 回答，答复；反应，响应
starve	[stɑːv] v. （使）挨饿；（使）饿死
ecosystem	[ˈiːkəusɪstəm] n. 生态系统
deteriorate	[dɪˈtɪərɪəreɪt] v. 变坏，恶化；退化
aeration	[eə'reɪʃn] n. 通风
assistant	|
orientate	[ˈɔːrɪənteɪt] vt. 使适应，使熟悉情况（或环境等）；给……定位，给……定向；使朝向；转至特定方向；适应（=orient）
feather	[ˈfeðə(r)] n. 羽毛，翎毛
vague	[veɪg] a. 模糊的；含糊的
mall	[mɔːl] n. 购物中心
withstand	[wɪðˈstænd; wɪθˈs-] vt. 抵挡；经受住
pack	|
Kung-Fu	Kung Fu [ˏkʌŋ ˈfu] n. 功夫
mould	|
apparently	[əˈpærəntli] ad. 显然；看来，似乎
attainable	[əˈteɪnəbl] a. 可获得的，可达到的，可实现的
textile	[ˈtekstaɪl] n. 纺织品
dispute	|
flight	[flaɪt] n. 航班
reluctant	[rɪˈlʌktənt] a. 不情愿的，勉强的；难得到的，难处理的
womb	[wuːm] n. 子宫；发源地
overshadow	[ˏəuvəˈʃædəu] vt. 给……蒙上阴影；使扫兴；使黯然失色
clinic	[ˈklɪnɪk] n. 门诊部，诊所
curious	[ˈkjuərɪəs] a. 好奇的；奇怪的
aeroplane	[ˈeərəpleɪn] n. 飞机
calorie	[ˈkælərɪ] n. 卡（路里）， 大卡（食物的热量）
soluble	[ˈsɔljubl] a. 可溶的；可解决的
forum	[ˈfɔːrəm] n. 论坛；讨论会
tab	__tag__ [tæb] n. 标签
timid	[ˈtɪmɪd] a. 胆小的；羞怯的
normal	[ˈnɔːml] a. 正常的，平常的；标准的，规范的，正规的
futile	[ˈfjuːtaɪl] a. 无效的，无用的，无意义的；（人）没出息的；琐细的
hose	|
unique	[juːˈniːk] a. 唯一的，独一无二的；极不寻常的，极好的
detach	[dɪˈtætʃ] v. 分开，分离；分遣
unyielding	[ʌnˈjiːldɪŋ] a. 顽强的；坚硬的；不能弯曲的，坚固的
tick-off	__tick off__ [tik ɔf] 用记号勾出，给……打核对号
celebrate	[ˈselɪbreɪt] v. 赞扬，歌颂；庆祝
prepare	[prɪˈpeə(r)] v. 准备，预备
demerit	[diːˈmerɪt] n. 过失；缺点，短处
demolition	[ˌdemə'lɪʃn] n. 拆除；破坏，毁坏
coarse	[kɔːs] a. 粗的；粗糙的；粗劣的
collect	[kəˈlekt] v. 收集，搜集；领取，接走；收（税等）；聚焦；积累
bookrest	['bʊkrest] n. 阅书架
excusable	[ɪkˈskju:zəbl] a. 可原谅的；可谅解的；可容许的
serial	|
treadmill	[ˈtredmɪl] n. （人或畜力的）踏车；累人的活；单调的例行工作，乏味繁重的工作
consumption	__comsumption__ [kənˈsʌmpʃn] n. 消耗（量）；消费（量）
recalcitrant	[rɪˈkælsɪtrənt] a. 顽抗的，反抗的
catastrophe	__catrastrophe__ [kəˈtæstrəfɪ] n. 大灾难
comply	[kəmˈplaɪ] vi. 遵从；服从
trinket	[ˈtrɪŋkɪt] n. 小装饰品；不值钱的珠宝
crowded	[ˈkraʊdɪd] a. 拥挤的；塞满的
cell	[sel] n. 细胞；小房间；电池
respond	[rɪˈspɔnd] vi. 回答，答复；响应；作出反应
tropical	[ˈtrɒpɪkl] a. 热带的；炎热的
affluent	[ˈæfluənt] a. 丰富的，富裕的
submit	[səbˈmɪt] v. 屈从；提交
superb	[suːˈpɜːb; sjuːˈpɜːb] a. 极好的；高质量的
practical	[ˈprktɪkl] a. 实际的，实用的；实践的，应用的
inhumane	[ˏɪnhjuːˈmeɪn] a. 不近人情的，残忍的，不人道的
dissolve	__desolve__ [dɪˈzɔlv] v. 溶解；解散；结束
cultivation	[ˌkʌltɪˈveɪʃn] n. 耕种，耕作；培养，教育
brazen	[ˈbreɪzn] a. 黄铜制的，黄铜色的；厚颜无耻的
previous	[ˈpriːvɪəs] a. 以前的，在……之前的；早先的，稍前的
assumption	[əˈsʌmpʃn] n. 假定，假设；担任，承担
repay	[rɪˈpeɪ] v. 归还（款项）；报答
exuberant	[ɪgˈzjuːbərənt] a. 繁茂的，丰富的；非凡的；华而不实的
antibiotic	|
particulate	|
strategy	[ˈstrætədʒɪ] n. 战略，策略
span	|
spoilage	__spoiladge__ [ˈspɔɪlɪdʒ] n. 变质；损坏
marble	[ˈmɑːbl] n. 大理石；弹子；[pl.] 弹子游戏
despite	[dɪˈspaɪt] prep. 不管，尽管
scholarship	[ˈskɔləʃɪp] n. 奖学金；学问，学识
logic	[ˈlɔdʒɪk] n. 逻辑；逻辑学
statement	[ˈsteɪtmənt] n. 陈述；声明；报表
interrelationship	[ˌɪntərɪˈleɪʃnʃɪp] n. 相互关联，相互影响
execution	[ˏeksɪˈkjuːʃn] n. 执行，实施；处决
periodical	|
relieve	_relieve___ [rɪˈliːv] vt. 救济；缓解
lava	[ˈlɑːvə] n. 岩浆，熔岩
dominant	[ˈdɔmɪnənt] a. 占优势的；统治的；居高临下的
outlook	[ˈautluk] n. 观点，见解；展望，前景
gross	[grəus] a. 总的，毛的
gallery	[ˈgælərɪ] n. 美术馆
process	|
inadequate	[ɪnˈædɪkwət] a. 不充分的；不适当的
coupon	[ˈkuːpɔn] n. 优惠券；票证；配给券；参赛表，订货单
orbit	|
flash	|
ID-card	ID card 身份证（= identity card）
density	[ˈdensətɪ] n. 密集；浓度，密度
legitimate	|
surgery	[ˈsɜːdʒərɪ] n. 外科学；外科手术；手术室，诊疗室
bibliography	[ˏbɪblɪˈɔgrəfɪ] n. 参考书目；书目；文献学
flexitime	[ˈfleksɪtaɪm] n. 弹性工作制
relevance	['reləvəns] n. 中肯，适当；相关性
emphasize	['emfəsaɪz] vt. 强调，着重
initial	|
clutch	|
feasible	[ˈfiːzəbl] a. 可行的，可能的；可做的，可实行的
track-and-field	track and field 田径
exposure	[ɪkˈspəuʒə(r)] n. 暴露；显露；接触；曝光
repel	[rɪˈpel] vt. 击退，驱逐；抵制，拒绝；使反感，使厌恶
occupy	[ˈɔkjupaɪ] vt. 占用，占领；（使）忙碌于；（使）从事
slip	|
abate	[əˈbeɪt] v. 减轻；降价
leukaemia	[luːˈkiːmɪə] n. 白血病
simulation	[ˌsɪmjuˈleɪʃn] n. 假装；模拟
impose	[ɪmˈpəuz] v. 把……强加于；征（税等）；处以（罚款、监禁等）
expectancy	[ɪk'spektənsɪ] n. 期待，期望；预期数额（如寿命等）
undetected	[ˌʌndɪˈtektɪd] a. 未被发现的
position	|
hide	|
observation	[ˏɔbzəˈveɪʃn] n. 观察，观测；监视；评述，评论
glamor	['glæmə] n. 魅力；诱惑力
consideration	[kənˏsɪdəˈreɪʃn] n. 考虑；思考；体谅
advertise	[ˈædvətaɪz] vt. 为……做广告；宣传；（在报刊、电视、广播中）公告，公布
vivid	[ˈvɪvɪd] a. 鲜艳的；生动的
guzzle	[ˈgʌzl] v. 狂饮，暴饮；大量消耗
lobby	|
periphery	[pəˈrɪfərɪ] n. 不重要的部分；外围
stove	[stəuv] n. 炉
sensational	[senˈseɪʃənl] a. 轰动性的，引起哗然的；耸人听闻的；极好的；绝妙的
rigorous	[ˈrɪgərəs] a. 严密的；严格的，严厉的；严酷的
corporate	__corpeorate__ [ˈkɔːpərət] a. 团体的，共同的；法人的，公司的
replace	[rɪˈpleɪs] vt. 代替；更换；把……放回原处
offend	[əˈfend] v. 冒犯；使厌恶；违犯
estrange	[ɪˈstreɪndʒ] vt. 使疏远，使分离
emeritus	[ɪˈmerɪtəs] a. 保留头衔而退休的，荣誉退休的
lounge	|
leaflet	|
monitor	|
discover	[dɪsˈkʌvə(r)] vt. 发现，找到；发觉
subtract	[səbˈtrækt] vt. 减去；去掉
peripheral	|
van	[væn] n. 运货车
laterality	[ˌlætə'rælɪtɪ] n. 对一侧面的偏重，偏向一侧状态
elaborate	|
captive	|
leopard	[ˈlepəd] n. 豹，美洲豹
robust	[rəuˈbʌst] a. 健壮的，强壮的；坚定的
vibrant	[ˈvaɪbrənt] a. 振动的；活泼的，充满生气的；兴奋的
instil	[ɪnˈstɪl] vt. 滴注；逐渐灌输；逐步培养（感受、思想等）
habitual	[həˈbɪtʃuəl] a. 惯常的，通常的
maintenance	[ˈmeɪntənəns] n. 维持；保养；抚养费
submarine	|
conversion	[kənˈvɜːʃn] n. 转化；转变，变换；兑换；改变信仰，皈依
discourage	[dɪˈskʌrɪdʒ] vt. 使泄气，使灰心；阻止，劝阻
lane	[leɪn] n. 小巷；行车道
downpour	[ˈdaunpɔː(r)] n. 暴雨
corrode	[kəˈrəud] v. 腐蚀；侵蚀
polish	|
setting	[ˈsetɪŋ] n. 环境；背景；安置
Cantonese	[ˏkæntəˈniːz] n./a. 广东人（的）；广东话（的）
qualification	[ˏkwɔlɪfɪˈkeɪʃn] n. 资格，合格；技能；限定，条件；合格证
intrusion	[ɪnˈtruːʒn] n. 闯入；打搅；侵扰
horror	[ˈhɔrə(r)] n. 害怕，恐怖
geographical	[ˌdʒi:ə'ɡræfɪkl] a. 地理学的；地理的
navigation	[ˌnævɪˈgeɪʃn] n. 航空，航海，航行；导航，领航
industrialise	[ɪn'dʌstrɪəlaɪz] v. （使）工业化
surge	|
cube	[kjuːb] n. 立方形；立方
boundary	[ˈbaundrɪ] n. 分界线；边界
propel	[prəˈpel] vt. 推进，推动；驱使
execute	[ˈeksɪkjuːt] vt. 将……处死；实施，执行
vile	[vaɪl] a. 糟糕透顶的，可恶的；恶劣的，卑鄙的
complicated	['kɒmplɪkeɪtɪd] a. 复杂的；难懂的
legitimacy	[lɪ'dʒɪtɪməsɪ] n. 合法性；正统性
promotion	[prəˈməuʃn] n. 提升，晋级；促进，增进；发起，发扬；宣传，推销
glutamate	['glu:təˌmeɪt] n. 谷氨酸；谷酸盐
shrink	[ʃrɪŋk] v. （使）收缩；萎缩
afford	[əˈfɔːd] v. 负担得起
magnitude	[ˈmægnɪtjuːd] n. 广大，巨大；重要，重要性；星体的亮度
involve	[ɪnˈvɔlv] vt. 使卷入，使参与；牵涉，陷入，连累；包含，含有
gelatin	['dʒelətɪn] n. 明胶
tense	|
appoint	[əˈpɔɪnt] vt. 任命，委任；指定（时间、地点等）
pregnant	[ˈpregnənt] a. 怀孕的，妊娠的；充满的
inversion	[ɪnˈvɜːʃn] n. 倒置，颠倒
glide	[glaɪd] vi./n. 滑行，滑翔
residence	[ˈrezɪdəns] n. 住宅，住处；居住
item	[ˈaɪtəm] n. 条款，项目； （新闻等）一则
buffalo	[ˈbʌfələu] n. 水牛；（北美）野牛
large-scale	[lɑ:dʒ skeɪl] a. 大规模的，大范围的
summit	[ˈsʌmɪt] n. （山等的）最高点，峰顶
respondent	[rɪˈspɔndənt] n. 回答者，响应者；调查对象；被告
dubious	[ˈdjuːbɪəs] a. 怀疑的；靠不住的，不确定的
differ	[ˈdɪfə(r)] vi. 不同，相异；（在意见方面）发生分歧
scan	-
juvenile	|
preface	|
typical	[ˈtɪpɪkl] a. 典型的
ruthless	[ˈru:θləs] a. 无情的，冷酷的，残忍的
abhorrent	[əbˈhɒrənt] a. 可恶的，可恨的
underground	|
interfere	[ˏɪntəˈfɪə(r)] vi. 干涉，干扰，妨碍
enlighten	[ɪnˈlaɪtn] vt. 启发；开导；阐明
uniform	|
refrain	|
charcoal	[ˈtʃɑːkəul] n. 炭，木炭
volunteer	|
procession	[prəˈseʃn] n. 队伍，行列
plaster	[ˈplɑːstə(r)] n. 灰泥，石膏；膏药
curative	[ˈkjuərətɪv] a. 有疗效的；医疗的
crash	[kræʃ] v. 碰撞；冲，闯；倒下，坠落；发出撞击（或爆裂）声；垮台，破产  n. 碰撞；坠落，坠毁；破裂声，撞击声  a. 速成的
border	|
reception	[rɪˈsepʃn] n. 接收，接受；接待，招待会；接收效果
variant	|
clarity	[ˈklærətɪ] n. 清楚
mushroom	|
booming	['bu:mɪŋ] a. 发展迅速的；激增的
dictation	__ditation__ [dɪkˈteɪʃn] n. 听写
reinvigorate	__reinvagorate__ [ˌri:ɪn'vɪɡəreɪt] vt. 使重新振作；使恢复活力
psychiatric	[ˌsaɪkiˈætrɪk] a. 精神病的；治疗精神病的
overweight	|
ape	|
dairy	|
gather	[ˈgæðə(r)] v. 聚焦，集合，聚拢；收集，采集；逐渐增加；猜想，推测
doctoral	[ˈdɒktərəl] a. 博士的
migration	[maɪ'greɪʃn] n. 迁徙，移居，移民
condone	[kənˈdəun] v. 宽恕，赦免；纵容，容忍
incongruity	[ˌɪnkɒn'ɡru:ətɪ] n. 不和谐，不相称；不协调或不一致的事物
module	[ˈmɔdjuːl] n. 模块；模式；（航空器中的）舱；组件；单元
cameral	['kæmərəl] a. （立法机关）院的
silicon	[ˈsɪlɪkən] n. 硅
dissertation	[ˏdɪsəˈteɪʃn] n. 专题论文
permeate	[ˈpɜːmɪeɪt] v. 扩散，弥漫；渗透，渗入
appearance	[əˈpɪərəns] n. 出现；外观
magic	|
decade	[ˈdekeɪd] n. 十年，十年期
ceremony	[ˈserɪmənɪ] n. 典礼；仪式
inspire	[ɪnˈspaɪə(r)] vt. 鼓舞，激起；给……以灵感
as-for	as for; as to 至于，关于
burglar	[ˈbɜːglə(r)] n. 窃贼
righteous	[ˈraɪtʃəs] a. 正义的，正直的；公正的；正当的
existence	[ɪɡ'zɪstəns] n. 存在；生活（方式）
disrupt	[dɪsˈrʌpt] vt. 使中断；扰乱
deficit	[ˈdefɪsɪt] n. 不足额，赤字
accomplish	[əˈkʌmplɪʃ] vt. 达到（目的），完成（任务），实现（计划、诺言等）
bloom	|
adolescent	|
ritual	|
introduce	[ˏɪntrəˈdjuːs] vt. 介绍；传入，引进；提出；采用，推行
incident	[ˈɪnsɪdənt] n. 发生的事；事件，事变
frequent	[ˈfriːkwənt] a. 频繁的，常见的，常用的
exhaustible	[ɪg'zɔ:stəbl] a. 可耗尽的，会枯竭的
vigorous	[ˈvɪgərəs] a. 朝气蓬勃的；有力的
immune	[ɪˈmjuːn] a. 免疫的，有免疫力的；有抵抗力的；不受影响的；免除的，免除惩罚的，豁免的
reject	|
verification	[ˌverɪfɪ'keɪʃn] n. 确认
bankruptcy	[ˈbæŋkrʌptsi] n. 破产；彻底失败
rudimentary	[ˌru:dɪˈmentri] a. 基本的，初步的；未充分发展的，发育不成熟的；退化的
cable	|
anxious	[ˈæŋkʃəs] a. 渴望的；忧虑的
astrology	[əˈstrɔlədʒɪ] n. 占星学；占星术
migrate	[maɪˈgreɪt] v. （候鸟等）迁徙；移居
acquaintance	__acquaitance__ [əˈkweɪntəns] n. 熟人；认识，了解
nasty	[ˈnɑːstɪ] a. 令人讨厌的；不友好的，恶意的，下流的；恶劣的
dissatisfied	[dɪˈsætɪsfaɪd] a. 不满意的，不满足的
perception	[pəˈsepʃn] n. 看法；感觉；洞察力
access	|
wastage	[ˈweɪstɪdʒ] n. 消耗量；损耗；（雇员的）减员
recover	[rɪˈkʌvə(r)] v. 重新获得，重新得到；使复原，使康复；收回，换回
casualty	[ˈkæʒuəltɪ] n. 伤亡（人员），伤亡者；损失的东西；伤亡事故
enroll	[ɪn'rəʊl] v. 入学，登记；加入；招收
grim	[grɪm] a. 严厉的；可怕的；讨厌的
subsidiary	|
poll	|
edify	[ˈedɪfaɪ] v. 陶冶，教化；启发，启迪
conclude	[kənˈkluːd] v. 推断出；作结论
biometrics	[ˌbaɪəʊ'metrɪks] n. 生物测定学
troupe	[truːp] n. （演出的）班子，团，队；（尤指）马戏团，芭蕾舞团
calendar	[ˈkælɪndə(r)] n. 日历；月历；日程表
bent	[bent] a. 被弄弯的，弯曲的  n. 爱好，天赋
fibre	[ˈfaɪbə(r)] n. 纤维
however	|
migratory	['maɪgrətrɪ] a. 迁徙的，迁居的；流动的，游牧的
cruel	['kru:əl] a. 残忍的，残暴的
torrent	[ˈtɔrənt] n. 洪流；爆发；（讲话等的）连发
rot	|
tedious	[ˈtiːdɪəs] a. 冗长乏味的，单调的
racket	[ˈrækɪt] n. （网球、羽毛球等的）球拍
exhale	[eksˈheɪl] v. 呼出（气）；散发（气味、蒸气等）
sediment	__sedimant__ [ˈsedɪmənt] n. 沉淀物；沉积物（如沙、砾、石、泥等）
enrich	[ɪnˈrɪtʃ] vt. 充实，使丰富；使富裕
influence	|
historic	[hɪˈstɔrɪk] a. 有历史意义的；历史的，历史性的
anticipate	[ænˈtɪsɪpeɪt] v. 预期，预料，期望；先于……行动
excitement	[ɪkˈsaɪtmənt] n. 激动；兴奋；令人兴奋的事
hive	|
assimilate	[əˈsɪməleɪt] v. 吸收；使同化
fluctuate	[ˈflʌktʃueɪt] v. （使）涨落，（使）起伏；（使）变化
fitness	[ˈfɪtnəs] n. 健康；适合（某事物）
blade	[bleɪd] n. 刀片；桨叶；（草的）叶片
orchestra	[ˈɔːkɪstrə] n. 管弦乐队
adventurous	[ədˈventʃərəs] a. 喜欢冒险的，敢做敢为的；充满危险和刺激的，惊险的
embezzlement	[ɪm'bezlmənt] n. 贪污，盗用
burrow	|
classify	[ˈklæsɪfaɪ] vt. 把……归类，把……分级
object	|
meaningful	['mi:nɪŋfl] a. 有目的的；有意义的
signpost	|
auditorium	[ˏɔːdɪˈtɔːrɪəm] n. 礼堂；观众席
manor	[ˈmnə(r)] n. 领地，庄园
agenda	[əˈdʒendə] n. 议程；议程表
typhoon	[taɪˈfuːn] n. 台风
skip	[skɪp] v. 跳，蹦；漏过；逃学
connection	[kəˈnekʃn] n. 连接；关系
reproduce	[ˏriːprəˈdjuːs] v. 繁殖，生育；复制，仿造，翻版；再现，使……在脑海中重现
minimum	|
inheritance	[ɪn'herɪtəns] n. 遗传；继承，继承物；遗产，遗赠
barrier	[ˈbærɪə(r)] n. 栅栏；关卡，检票口；障碍，隔阂；屏障
coach	|
tease	|
elastic	|
subliminal	[ˏsʌbˈlɪmɪnl] a. 下意识的，潜意识的
excessive	[ɪkˈsesɪv] a. 过多的，极度的，过分的
insignificant	[ˏɪnsɪgˈnɪfɪkənt] a. 无关紧要的，无意义的
throughout	[θruːˈaut] prep. lad. 各处；遍及；在整个……期间
shilling	[ˈʃɪlɪŋ] n. 先令
democratic	[ˏdeməˈkrætɪk] a. 民主的，有民主精神的
departure	[dɪˈpɑːtʃə(r)] n. 离开，出发；背离，违反
explore	[ɪkˈsplɔː(r)] v. 探险，探索；仔细检查，探究
requisite	|
primitive	|
dizzy	[ˈdɪzɪ] a. 头晕目眩的，眩晕的；（使）人头晕的
translate	[træns'leɪt] v. 翻译
furious	[ˈfjuərɪəs] a. 狂怒的；激烈的
enterprise	[ˈentəpraɪz] n. 企业，公司；事业
thrive	[θraɪv] vi. 兴旺，繁荣
outdo	[ˏautˈduː] vt. 超越，胜过
mature	|
roller	[ˈrəulə(r)] n. 滚筒；滚轴
disagree	[ˏdɪsəˈgriː] v. 不同意；不一致
evacuate	[ɪˈvækjueɪt] v. 疏散；撤离
dynamic	[daɪˈnæmɪk] a. 动力的；活跃的，充满活力的，精力充沛的
data	[ˈdeɪtə] n. 数据；资料
microscope	__micorscope__ [ˈmaɪkrəskəup] n. 显微镜
ailment	[ˈeɪlmənt] n. （不严重的）疾病
classification	[ˏklæsɪfɪˈkeɪʃn] n. 分类；级别
pulverise	[ˈpʌlvəraɪz] vt. 碾磨成粉，粉碎
relative	|
territory	[ˈterətrɪ] n. 领土，版图；领域，范围
signal	|
induction	[ɪnˈdʌkʃn] n. 就职；归纳；感应
gauge	|
murky	[ˈmɜ:ki:] a. 浑浊的；黑暗的；朦胧的；隐晦的
commitment	[kə'mɪtmənt] n. 委托；许诺；承担义务
sequence	[ˈsiːkwəns] n. 一系列，一连串；顺序，次序
paralysis	[pəˈræləsɪs] n. 瘫痪，麻痹，中风
specification	[ˏspesɪfɪˈkeɪʃn] n. [常pl.] 规格，规范；明确说明；（产品等的）说明书
atmosphere	[ˈætməsfɪə(r)] n. 大气；气氛；环境
exploratory	[eksˈplɔ:rətɵrɪ] a. 探测的；勘探的；探索的
damage	|
sliver	_silver__ [ˈslɪvə(r)] n. 银；银器
dearth	[dɜːθ] n. 缺乏，短缺
isle	[aɪl] n. 小岛，岛
intent	|
premium	[ˈpriːmɪəm] a. 高级的，优质的；售价高的  n. （投保人向保险公司支付的）保险金；额外费用，加付款；奖品，赠品；额外津贴
meanwhile	[ˈmiːnwaɪl] ad. 与此同时
construction	[kənˈstrʌkʃn] n. 建造；建筑物；构造
aggressiveness	[ə'ɡresɪvnəs] n. 侵略；争斗；攻击
corps	[kɔː(r)] n. 部队；军团
outweigh	[ˏautˈweɪ] vt. 比……重；（在重要性、影响上）比……更重要；胜过，强于
twofold	|
subtropical	[ˏsʌbˈtrɔpɪkl] a. 亚热带的
exact	[ɪgˈzækt] a. 精确的；准确的
fabulous	[ˈfæbjuləs] a. 寓言式的；极为巨大的；极好的
abstract	|
optometrist	[ɒpˈtɒmətrɪst] n. 验光师，视力测定者
curtail	[kɜːˈteɪl] vt. 缩短，消减；剥夺
remote	[rɪˈməut] a. 远的，长久的；遥远的，偏僻的；远程的；关系疏远的，脱离的；绝少的，微乎其微的；孤高的，冷淡的
stripe	[straɪp] n. 条纹
detergent	|
advantage	[ədˈvɑːntɪdʒ] n. 优点；优势
cosmopolitan	|
judicious	[dʒuːˈdɪʃəs] a. 明智的；有见识的
export	|
client	[ˈklaɪənt] n. 委托人；顾客，客户
mantle	|
appear	[əˈpɪə(r)] v. 出现，显露，公开露面；出场，问世；仿佛，似乎
credential	[krəˈdenʃl] n. 证明书；（学历、资历）资格证书；证件
separate	|
haul	[hɔːl] vt. 用力拖；搬运
ancestral	[æn'sestrəl] a. 祖先的；祖传的
dispenser	[dɪˈspensə(r)] n. 药剂师，配药师；分配者，施予者；自动售货机
accommodation	[əˏkɔməˈdeɪʃn] n. 住处，膳宿；适应，调节
analyse	__analysis__ [ˈænəlaɪz] vt. 分析；分解
pedal	|
diversity	[daɪˈvɜːsətɪ] n. 多样性；差异
overdue	[ˏəuvəˈdjuː] a. 过期未付的；逾期的；过度的，过火的；迟到的，延误的
reconstruction	[ˌri:kən'strʌkʃn] n. 重建；再现
chase	[tʃeɪs] v. 追捕；追求；雕镂
treatise	[ˈtriːtɪz] n. 论文；专著
consolation	[ˏkɔnsəˈleɪʃn] n. 安慰；慰问
dialect	[ˈdaɪəlekt] n. 方言，土语
quote	|
dreadful	[ˈdredfl] a. 可怕的；令人不快的
stationary	[ˈsteɪʃənrɪ] a. 静止的，不动的，固定的；稳定的
cinematography	[ˌsɪnəməˈtɒgrəfi] n. 电影摄影术
bar	|
fusion	[ˈfjuːʒn] n. 熔化，熔合；聚变
feminism	[ˈfemɪnɪzəm] n. 男女平等主义；女权主义；女权运动
horizon	[həˈraɪzn] n. 地平线；范围；眼界
available	_available___ [əˈveɪləbl] a. 可获得的，可得到的；可用的；有空的
burgeon	[ˈbɜːdʒən] vi. 迅速成长；发展
enclose	[ɪnˈkləuz] vt. 围住；附上；把……装入信封
steer	[stɪə(r)] v. 引导；驾驶
originate	[əˈrɪdʒɪneɪt] v. 起源，发生；首创，创造
thunder	|
mention	[ˈmenʃn] n./v. 提及，说起
geology	[dʒɪˈɔlədʒɪ] n. 地质学；地质概况
degenerate	|
distribute	[dɪˈstrɪbjuːt] vt. 分发，分配，分送；散布，分布；分类，分区
pasture	|
benevolent	[bɪˈnevələnt] a. 善心的，仁心的
dose	[dəus] n. 剂量，一剂
unprejudiced	[ʌnˈpredʒədɪst] a. 无偏见的；公正的
upper	[ˈʌpə(r)] a. 上面的；地位较高的
greatly	[ˈgreɪtli] ad. 非常；很；极大地
sketch	|
fortnight	[ˈfɔːtnaɪt] n. 两星期，十四天
suppression	__supression__ [səˈpreʃn] n. 镇压，压制，抑制；扑灭
spring	|
current	|
confusion	[kənˈfjuːʒn] n. 困惑，糊涂；混淆；混乱，杂乱，无秩序状态，骚乱
hinder	[ˈhɪndə(r)] vt. 阻碍，妨碍
prospective	[prəˈspektɪv] a. 预期的；未来的；可能的
overview	[ˈəuvəvjuː] n. 综览，概述
zoological	[‚zəʊə'lɑdʒɪkl] a. 动物学的
simultaneous	[ˏsɪmlˈteɪnɪəs] a. 同时的，同时发生的，同时存在的；同步的
lead-to	lead to  导致，通向
disruptive	[dɪsˈrʌptɪv] a. 制造混乱的；分裂性的；破坏性的
install	[ɪnˈstɔːl] vt. 安顿，安置；安装，设置；正式任命，使正式就职
remarkable	[rɪˈmɑ:kəbl] a. 引人注目的，显著的，值得注意的；异常的，非凡的
configuration	__configuraion__ [kənˏfɪgəˈreɪʃn] n. 结构，配置；轮廓，外形
salinity	[sə'lɪnətɪ] n. 盐分，盐度
simulate	[ˈsɪmjuleɪt] vt. 模仿，模拟；假装，伪装；扮演
millennium	[mɪˈlenɪəm] n. 一千年，千禧年；（未来的）太平盛世
establish	[ɪˈstæblɪʃ] vt. 建立；确立；安置，使安居
sociology	[ˏsəusɪˈɔlədʒɪ] n. 社会学
latitude	[ˈlætɪtjuːd] n. 纬度；[pl.] 纬度地区；（言行等的）自由
shorthand	[ˈʃɔ:thænd] n. 速记法；速记
presuppose	[ˏpriːsəˈpəuz] vt. 预先假定……属实；认为，假设；以……为先决条件，以……为前提
download	[ˏdaunˈləud] v. 下载
lexicographer	[ˌleksɪˈkɒgrəfə(r)] n. 词典编纂者
insecure	[ˏɪnsɪˈkjuə(r)] a. 不安全的，不可靠的
besides	|
skim	[skɪm] v. 撇去；掠过，擦过；浏览，略读
substitution	[ˌsʌbstɪ'tju:ʃn] n. 代替，置换；代入法
insufficient	[ˏɪnsəˈfɪʃnt] a. 不足的，不够的
milestone	['maɪlstəʊn] n. 里程碑；转折点
scholar	[ˈskɔlə(r)] n. 学者；奖学金获得者
deduce	[dɪˈdjuːs] v. 演绎，推断
recommend	[ˏrekəˈmend] vt. 推荐；劝告；使受欢迎
discovery	[dɪˈskʌvərɪ] n. 发现
pump	|
oxide	[ˈɔksaɪd] n. 氧化物
renewable	[rɪˈnju:əbl] a. 可更新的，可再生的，可恢复的；可延长有效期的，可续期的
foam	|
arousal	[ə'raʊzl] n. 唤起，激起
capable	[ˈkeɪpəbl] a. 有能力的；能够的
divine	[dɪˈvaɪn] a. 神的；神授的，天赐的
conformity	[kən'fɔ:mɪtɪ] n. 符合，一致
elaboration	[ɪˌlæbə'reɪʃn] n. 精心之作；详尽阐述
deprive	[dɪˈpraɪv] vt. 剥夺；使丧失
stint	[stɪnt] n. 定量；限额
spot-on	spot on  恰好的（地），准确的（地）
cosmic	[ˈkɔzmɪk] a. 宇宙的
conform	[kənˈfɔːm] vi. 遵守，服从；适应，顺应；相一致，相符合
sophisticate	[sə'fɪstɪkeɪt] n. 久经世故的人；精通者
hostile	[ˈhɔstaɪl] a. 敌方的；不友善的；不利的
convey	[kənˈveɪ] vt. 传送，运送；表达，传递
dwindle	[ˈdwɪndl] v. （使）变小，（使）缩小
introvert	[ˈɪntrəvɜːt] n. 性格内向的人
database	['deɪtəbeɪs] n. 数据库
dispiriting	[dɪˈspɪrɪtɪŋ] a. 令人沮丧的，使人气馁的
administration	__adminstration__ [ədˏmɪnɪˈstreɪʃn] n. 管理（部门）；行政（机关）
insurance	[ɪnˈʃʊərəns] n. 保险；保险费；保险业
slope	|
comprehensive	[ˏkɔmprɪˈhensɪv] a. 全面的，广泛的；综合的；包容的
enquire	[ɪnˈkwaɪə(r)] v. 打听，询问；查问，调查
draft	|
slender	[ˈslendə(r)] a. 修长的，细长的，苗条的；微小的，微薄的
crawl	|
herbivore	[ˈhɜːbɪvɔː(r)] n. 食草动物
lavatory	[ˈlævətrɪ] n. 盥洗室，厕所
vernacular	|
dealer	[ˈdiːlə(r)] n. 商人，经销商
criticise	[ˈkrɪtɪsaɪz] v. 批评，非难，责备；评论
admit	[ədˈmɪt] v. 承认；准许……进入；准许……加入
exceed	[ɪkˈsiːd] v. 超过，胜过
misconception	[ˌmɪskənˈsepʃn] n. 误解，错误想法
routine	|
scent	|
positive	[ˈpɔzətɪv] a. 明确的；肯定的；积极的
fountain	[ˈfauntɪn] n. 喷泉
firm	|
fantastic	[fænˈtæstɪk] a. 极好的；荒诞的，奇异的；不切实际的
mutual	[ˈmjuːtʃuəl] a. 相互的；共同的
focus	|
consultant	[kənˈsʌltənt] n. 顾问；专科医生
competition	[ˏkɔmpəˈtɪʃn] n. 竞争；比赛
project	|
context	[ˈkɔntekst] n. 上下文；背景；环境
breed	|
jargon	[ˈdʒɑːgən] n. 行话，行业术语；黑话
stammer	|
cash	|
collate	[kəˈleɪt] vt. 对照；核对；整理（文件、书页等）
disrespectful	[ˌdɪsrɪ'spektfl] a. 失礼的，无礼的
electronic	[‚ɪlek'trɒnɪk] a. 电子的
muddle	|
overwork	|
gesture	|
slogan	[ˈsləugən] n. 标语，口号
delta	[ˈdeltə] n. 三角洲；希腊字母表的第四个字母
vanish	[ˈvænɪʃ] vi. 突然消失； 不复存在，消逝
assessment	[əˈsesmənt] n. 判定，评定；核定的付款额；看法，评价
inflict	[ɪnˈflɪkt] vt. 把……强加给，使遭受，使承受
annoy	[əˈnɔɪ] vt. 使烦恼；打搅
consecutive	[kənˈsekjutɪv] a. 连续不断的，连贯的
bay	[beɪ] n. 海湾
expectation	[ˏekspekˈteɪʃn] n. 期待，预期； [pl.] 前程，成功的前景
ensue	[ɪnˈsjuː] vi. 继而发生；接着发生
forthcoming	[ˏfɔːθˈkʌmɪŋ] a. 即将到来的
calibrate	[ˈkælɪbreɪt] vt. 标定，划分；校准刻度
memorandum	[ˏmeməˈrændəm] n. 备忘录，摘要
precedent	[ˈpresɪdənt] n. 先例，范例；惯例
removal	[rɪ'mu:vl] n. 除去；免职；搬迁
manual	|
differentiate	[ˏdɪfəˈrenʃɪeɪt] v. 区分，区别；差别对待，区别对待
revive	[rɪˈvaɪv] v. （使）苏醒，复活；重新使用
display	[dɪˈspleɪ] vt./n. 陈列，展览；显示，表现
demonstration	[ˏdemənˈstreɪʃn] n. 论证，证明；示范；显示，表露；示威游行
image	[ˈɪmɪdʒ] n. 形象；印象；图像
precede	[prɪˈsiːd] v. 领先，先于
incoming	|
underline	[ˏʌndəˈlaɪn] vt. 画线于……之下；强调
portable	[ˈpɔːtəbl] a. 便于携带的；手提式的
deliver	[dɪˈlɪvə(r)] v. 交付，递送；发表，表达；释放；接生
overall	[ˏəuvərˈɔːl] a. 全面的；全部的
exist	[ɪgˈzɪst] vi. 存在；生存
physician	[fɪˈzɪʃn] n. 内科医生，医师
chef	[ʃef] n. 厨师长，厨师
multiply	[ˈmʌltɪplaɪ] v. （使）增加，（使）繁殖；乘
consequent	[ˈkɔnsɪkwənt] a. 作为结果的；随之发生的
registration	[ˏredʒɪˈstreɪʃn] n. 登记，注册；（邮件等的）挂号；登记或注册的项目
applaud	[əˈplɔːd] v. （向……）鼓掌，喝彩；称赞
adequate	[ˈædɪkwət] a. 充足的；合适的，合格的
melt	[melt] v. （使）融化；（使）消散
spit	|
optical	[ˈɔptɪkl] a. 视力的；光学的
vegetation	[ˏvedʒɪˈteɪʃn] n. 植物，草木
blueprint	[ˈbluːprɪnt] n. 蓝图；方案
ignorant	[ˈɪgnərənt] a. 无知的；愚昧的
invalid	|
interpretation	[ɪnˌtɜ:prɪˈteɪʃn] n. 口译；解释，诠释；（表演、演奏的）艺术处理
fuse	|
subscribe	[səbˈskraɪb] v. 订阅，订购；申请，预订
occasion	|
raw-material	raw material [rɔːməˈtiəriəl] n. 原材料
outward	[ˈautwəd] a. 外面的；外表的，表面的
stuffy	[ˈstʌfɪ] a. 不透气的，（空气）不新鲜的，不通风的；乏味的
profitable	[ˈprɔfɪtəbl] a. 有利可图的，赚钱的；有益的
constituent	|
informant	[ɪnˈfɔ:mənt] n. 提供消息或情报的人，线人；提供资料的人
nuclear	[ˈnjuːklɪə(r)] a. 核能的，原子能的
eyesight	[ˈaɪsaɪt] n. 视力
contaminate	[kənˈtæmɪneɪt] n. 致污物，污染物
insulate	[ˈɪnsjuleɪt] vt. 使绝缘，使隔热，使隔音；隔离；使隔绝（以免受到影响）
irresistible	__irresitible__ [ˏɪrɪˈzɪstəbl] a. 无法抵抗的，不能压制的；不能自己的
match	|
antiquity	[ænˈtɪkwətɪ] n. 古，古老；古代；古人；古迹，古物
relax	[rɪ'læks] v. （使）放松
infer	[ɪnˈfɜː(r)] v. 推断，猜想
mount	|
regardless	[rɪˈgɑ:dləs] ad. 不顾后果地；无论如何
register	|
brochure	[ˈbrəʊʃə(r)] n. 小册子；说明书
supplementary	[ˏsʌplɪˈmentrɪ] a. 增补的，补充的
ignore	[ɪgˈnɔː(r)] vt. 不顾，不理，忽视
flexibility	__fexibility__ [ˌfleksə'bɪlətɪ] n. 柔韧，有弹性；柔顺，温顺；灵活性；适应性
untrustworthy	[ʌnˈtrʌstwɜ:ði] a. 不值得信任的，靠不住的
poultry	[ˈpəultrɪ] n. 家禽；禽肉
decapitate	[dɪˈkæpɪteɪt] vt. 斩首
subsidise	['sʌbsɪdaɪz] vt. 津贴，资助
heartless	['hɑ:tləs] a. 无情的，狠心的；无生气的，没精打采的
solemn	[ˈsɔləm] a. 庄严的，隆重的；严肃的，认真的
associate	|
lever	|
transient	|
internship	['ɪntɜːnʃɪp] n. 实习身份；实习医师
hollow	|
construct	|
requirement	[rɪ'kwaɪəmənt] n. 需要，需求，要求；需要的东西；必要条件
afflicting	[ə'flɪktɪŋ] a. 痛苦的
endeavour	[ɪnˈdevə(r)] n./vi. 努力，尽力；尝试
facilitate	___facilitate_ [fəˈsɪlɪteɪt] vt. 使便利，使容易；推动，帮助
inductive-reasoning	__inductive__ __reasoning__ [inˈdʌktiv ˈri:zənɪŋ] 归纳；推理
amateur	|
imaginative	[ɪ'mædʒɪnətɪv] a. 富有想象力的；创新的
bark	|
decrepit	[dɪˈkrepɪt] a. 破旧的；衰老的
suitcase	[ˈsu:tkeɪs] n. 手提箱；衣箱
shrewd	[ʃruːd] a. 机灵的；精明的
cover	|
industrious	[ɪnˈdʌstrɪəs] a. 勤奋的，勤勉的，勤劳的
nickel	__neckel__ [ˈnɪkl] n. 镍；（美国或加拿大的）五分镍币
pollutant	[pəˈlu:tənt] n. 污染物质（尤指排入水中和空气中的有害化学物质），有害物质
hypothesis	[haɪˈpɔθəsɪs] n. 假设，假定；假说；猜想
finitude	['faɪnɪtju:d] n. 有限；限定，界限
weigh	[weɪ] v. 称重；认真考虑，权衡
strike	|
outpost	[ˈautpəust] n. 前哨（站）；偏远村落
argument	[ˈɑːgjumənt] n. 争吵，争论；观点，论据；说理，论证
wander	[ˈwɔndə(r)] v. 徘徊，闲逛，漫步；偏离正道；走神，（神情）恍惚
fauna	[ˈfɔːnə] n. （某地区或某时期的）所有动物
height	__hight__ [haɪt] n. 海拔；身高
amphibious	[æmˈfɪbɪəs] a. 两栖的；水陆两用的
calcium	[ˈkælsɪəm] n. 钙
convention	[kənˈvenʃn] n. 大会，会议；惯例，常规，习俗；公约，协定
attribute	|
describe	__discribe__ [dɪˈskraɪb] vt. 描述，描写，形容
cheat	|
intervene	[ˏɪntəˈviːn] vi. 干涉，干扰；介于其间
compromise	|
fascinating	[ˈfæsɪneɪtɪŋ] a. 迷人的
protrude	[prəˈtruːd] v. （使）伸出；（使）突出
swing	|
proof	|
worm	[wɜːm] n. 虫，蠕虫；蜗杆，螺纹
dizziness	['dɪzɪnəs] n. 头昏眼花，眩晕
exodus	[ˈeksədəs] n. 大批离去，成群外出
otherwise	|
storey	[ˈstɔːrɪ] n. 楼层
whisper	[ˈwɪspə(r)] n./v. 低语
maritime	[ˈmærɪtaɪm] n. 海的，海事的；海运的
refund	|
interface	[ˈɪntəfeɪs] n. 界面；接口；接合点
barely	[ˈbeəli] ad. 仅仅，几乎不；赤裸裸地，无遮蔽地
wildlife	[ˈwaɪldlaɪf] n. 野生生物
vessel	[ˈvesl] n. <总称>船只；容器；血管
organic	[ɔːˈgænɪk] a. 器官的；有机的；有机体的；组织的
probability	[ˏprɔbəˈbɪlətɪ] n. 可能性；概率
invaluable	[ɪnˈvæljuəbl] a. 无价的
passport	[ˈpɑːspɔːt] n. 护照；途径，路子，手段
adopt	[əˈdɔpt] v. 采用，采取，采纳；收养，领养；正式通过，批准
disruption	[dɪs'rʌpʃn] n. 动乱；打乱；破坏
swift	[swɪft] a. 快的；敏捷的，迅速的
conquest	[ˈkɔŋkwest] n. 征服；战利品
frequency	[ˈfriːkwənsɪ] n. 频繁；频率
heritage	[ˈherɪtɪdʒ] n. 遗产；传统
optional	|
minority	[maɪˈnɔrətɪ] n. 少数；少数民族
drill	[drɪl] v./n. 钻；训练
represent	[ˏreprɪˈzent] vt. 代表；表示；表现
circulation	[ˏsɜːkjuˈleɪʃn] n. （体液的）循环，（水、空气等的）流通；流传，传播；发行，发行量
unveil	[ˏʌnˈveɪl] v. 揭去面纱或覆盖物；揭幕；首次公开、揭露或展示（某事物）
convection	[kənˈvekʃn] n. 传送；对流
privilege	|
complex	|
up-to-date	up to date  [ˏʌp tə ˈdeɪt] a. 直到最近的；现代的
inactive	[ɪnˈæktɪv] a. 不活动的；懒散的
waist	[weɪst] n. 腰，腰部
disobey	[ˏdɪsəˈbeɪ] v. 不服从，违抗
slippery	[ˈslɪpərɪ] a. 滑的，滑溜的；油滑的，狡猾的；棘手的
conduct	|
bead	[biːd] n. 珠子；（水、血、汗的）小滴
precise	[prɪˈsaɪs] a. 精确的，准确的；严谨的
marvellous	[ˈmɑ:vələs] n. 令人惊奇的；奇特的，非凡的；奇迹般的，不可思议的；绝妙的
format	|
naked	[ˈneɪkɪd] a. 裸体的，无遮蔽的
cluster	|
stainless	['steɪnlɪs] a. 不锈的；无污点的，无瑕疵的
meantime	|
inclination	[ˏɪŋklɪˈneɪʃn] n. 爱好；趋势；倾斜
brass	[brɑːs] n. 黄铜；黄铜器；铜管乐器
benefit	|
privacy	[ˈprɪvəsɪ] n. 隐私，私事；隐私权
subsidy	[ˈsʌbsɪdɪ] n. 津贴，补助金
mandarin	[ˈmændərɪn] n. 橘子；达官贵人，官僚；[M-] 普通话
bare	[beə(r)] a. 赤裸的，光秃的
unsanitary	[ʌnˈsænətri] a. 不卫生的（= insanitary）
civil	[ˈsɪvl] a. 国民的；民用的；政府的
nightmare	[ˈnaɪtmeə(r)] n. 噩梦；可怕的事物
preventative	[prɪ'ventətɪv] a. 预防性的
dispense	[dɪˈspens] vt. 分发，分配；提供
compatriot	[kəmˈpætrɪət] n. 同胞；同国人
geometric	[ˌdʒi:əˈmetrɪk] n. 几何的，几何学的
shutter	[ˈʃʌtə(r)] n. 百叶窗；（照相机的）快门
literacy	[ˈlɪtərəsɪ] n. 有文化；有教养；读写能力
level	|
extinction	[ɪkˈstɪŋkʃn] n. 灭绝，绝种；熄灭
require	[rɪˈkwaɪə(r)] vt. 需要；命令；规定，要求
platform	[ˈplætfɔːm] n. 平台，站台；纲领
therapy	[ˈθerəpɪ] n. 治疗，疗法
wonder	|
bounce	|
canoe	[kəˈnuː] n. 独木舟
paramount	|
theory	[ˈθɪərɪ] n. 理论，原理；学说；意见，看法
casual	[ˈkæʒuəl] a. 偶然的，碰巧的，不经意的；临时的，非正式的
receiver	[rɪˈsiːvə(r)] n. （电话）听筒；接收器
moderation	[ˏmɔdəˈreɪʃn] n. 温和，中庸；适度，合理
aeronautics	__aronautics__ [ˏeərəˈnɔːtɪks] n. 航空学
grind	|
fasten	[ˈfɑːsn] v. 扎牢，扣住
acquire	[əˈkwaɪə(r)] vt.  取得，获得
ingenuity	[ˌɪndʒə'nju:ətɪ] n. 心灵手巧，足智多谋；巧妙，精巧
ozone	[ˈəuzəun] n. 臭氧
texture	[ˈtekstʃə(r)] n. 质地，纹理；口感
ensure	[ɪnˈʃɔː(r)] vt. 确保，保证；担保；赋予
refrigerator	__refirgerator__ [rɪ'frɪdʒəreɪtə(r)] n. 冰箱；冷藏库
campaign	|
trapeze	[trəˈpiːz] n. 高空秋千；吊架
isolate	[ˈaɪsəleɪt] vt. 使陆离，使孤立
exorbitant	[ɪgˈzɔːbɪtənt] a. 过分的，不合理的
committee	[kəˈmɪtɪ] n. 委员会，全体委员
natural	[ˈnætʃrəl] a. 正常的，普通的，自然的；自然界的，天然的；天赋的，固有的
inalienable	[ɪnˈeɪlɪənəbl] a. 不可剥夺的，不可分割的
victimise	[ˈvɪktɪmaɪz] v. （使）受害，迫害
deception	[dɪˈsepʃn] n. 欺骗；诡计
emerge	[ɪˈmɜːdʒ] vi. 出现；显露，（事实等）暴露
extravagance	[ɪkˈstrævəgəns] n. 奢侈，挥霍；放肆的言行
point	|
pension	[ˈpenʃn] n. 养老金，抚恤金；年金
flap	|
freight	|
splint	|
intention	[ɪnˈtenʃn] n. 意图，目的
determine	[dɪˈtɜːmɪn] v. 确定；决定；（使）下决心
inferential	[ˌɪnfə'renʃəl] a. 可推断的，推理的
dusk	[dʌsk] n. 薄暮，黄昏
lower	[ˈləuə(r)] a. 较低的；下面的  v. 降低，减少
astronomy	[əˈstrɔnəmɪ] n. 天文学
quiver	[ˈkwɪvə(r)] v. 颤抖，抖动
comet	[ˈkɔmɪt] n. 彗星
overseas	|
enormous	[ɪˈnɔːməs] a. 巨大的，庞大的，极大的
allocation	[ˌæləˈkeɪʃn] n. 配给，分配，安置；配给量
budget	|
primarily	[praɪˈmerəli] ad. 首先；主要地，首要地
moderately	[ˈmɒdərətli] ad. 适度地，不过分地，有节制地
courageous	[kə'reɪdʒəs] a. 勇敢的，有胆量的
predominantly	[prɪˈdɒmɪnəntli] ad. 主要地；重要地；显著地
concur	[kənˈkɜː(r)] v. 同时发生；意见相同，一致
malevolent	[məˈlevələnt] a. 有恶意的；恶毒的
launch	|
volume	[ˈvɔljuːm] n. 卷，册；体积；音量
stereo	|
underpin	[ˏʌndəˈpɪn] vt. 加固……的基础；加强，巩固
painstaking	|
objectify	[əb'dʒektɪfaɪ] vt. 使客观化；使具体化；物化
cassette	[kəˈset] n. 盒式录音（或录像）带
blaze	|
sinister	[ˈsɪnɪstə(r)] a. 不吉祥的，凶兆的；险恶的，邪恶的
comparable	[ˈkɔmpərəbl] a. 可比较的，类似的；比得上的
conclusion	[kənˈkluːʒn] n. 结论，推论；结束，结尾；[法] 缔结，认定
mastery	[ˈmɑːstərɪ] n. 精通，熟练；控制
naturally	[ˈnætʃrəlɪ] ad. 当然，自然；天生地
lease	|
permission	[pəˈmɪʃn] n. 允许，准许
transfer	|
restore	[rɪˈstɔː(r)] vt. 恢复，使复位；修复，整修，重建；归还，交还
smear	[smɪə(r)] v. 胡乱涂抹；弄脏，弄污；诽谤，诋毁；变得模糊不清，把（图画等）弄得模糊不清  n. 污迹，污渍；（显微镜的）涂片；诽谤，诋毁
short-term	[ʃɔ:t tɜ:m] a. 短期的
consignment	[kən'saɪnmənt] n. 交付，委托；投递，发送；所托运的货物
ambulance	[ˈæmbjuləns] n. 救护车；野战医院
branch	[brɑːntʃ] n. 树枝；分部，分科
successive	[səkˈsesɪv] a. 连续的
hatch	|
gravel	[ˈgrævl] n. 沙砾，砾石
preserve	[prɪˈzɜːv] vt. 保护；维持；保存，保藏；腌渍
slurry	[ˈslʌrɪ] n. 泥浆
spark	[spɑːk] n. 火花
enthusiasm	[ɪnˈθjuːzɪæzəm] n. 热情，热心，积极性；热衷的事物
traditional	[trəˈdɪʃənl] a. 传统的，惯例的；口传的，传说的
innovative	__innovatve__ ['ɪnəveɪtɪv] a. 革新的，创新的，新颖的；富有革新精神的
spacecraft	[ˈspeɪskrɑ:ft] n. 航天器，宇宙飞船
as-though	好像，仿佛as-if/though
appreciate	[əˈpriːʃɪeɪt] v. 赏识，鉴赏；感激；涨价，增值
violence	[ˈvaɪələns] n. 暴力行为；激烈，猛烈
coincide	[ˏkəuɪnˈsaɪd] vi. 同时发生；一致
kindergarten	[ˈkɪndəgɑːtn] n. 幼儿园
segregate	[ˈsegrɪgeɪt] vt. 隔离，（使）分开
council	[ˈkaunsl] n. 理事会，委员会
novice	[ˈnɔvɪs] n. 生手，新手；初学者；新信徒，初学修士（或修女）
chief	[tʃiːf] a. 主要的；为首的
extend	[ɪkˈstend] v. 延长；扩大
compulsively	[kəm'pʌlsɪvlɪ] ad. 强制地；禁不住地
turret	[ˈtʌrɪt] n. 塔楼，角楼
stall	[stɔːl] n. 货摊；小隔间
permanent	[ˈpɜːmənənt] a. 永久的，持久的
cervical	[ˈsɜ:vɪkl] a. 子宫颈；颈部的
post-mortem	|
uphill	[ˏʌpˈhɪl] ad. 向上，往上；上坡；艰难地
slash	|
frown	[fraun] vi. （表示愤怒或烦心而）皱眉
electrical	[ɪˈlektrɪkl] a. 电的，电学的，有关电的
bubble	|
irregularity	[ɪˌregjəˈlærəti] n. 不规则，无规律
lag	|
aware	[əˈweə(r)] a. 知道的；意识到的
begrudge	[bɪˈgrʌdʒ] vt. 对……感到不满；嫉妒；勉强做，不乐意地做
pour	[pɔː(r)] v. 灌，倒；倾泻，涌流；喷发；不断涌现
suppress	[səˈpres] vt. 压制，镇压；禁止发表；查禁；抑制（感情等），忍住；阻止……的生长（或发展）
in-addition	in addition 另外；加之
prevail	___prevail_ [prɪˈveɪl] vi. 流行，盛行；占优势，战胜
refresh	[rɪˈfreʃ] v. （使）复原，更新；（使）精神振作，（使）精力恢复
adventure	[ədˈventʃə(r)] n. 冒险，冒险活动；异乎寻常的经历，奇遇
literal	[ˈlɪtərəl] a. 照字面的；逐字的
stimulate	[ˈstɪmjuleɪt] vt. 刺激；使兴奋；激发，激励
collaboration	[kəˌlæbəˈreɪʃn] n. 合作，协作；勾结，通敌
disempower	[dɪsɪm'paʊər] vt. 使失去权力或影响
merely	[ˈmiəli] ad. 仅仅，只不过
enrolment	[ɪnˈrəʊlmənt] n. 登记（人数），注册（人数）；入学，入伍；登记簿，名册
suggest	[səˈdʒest] v. 建议，提出；暗示
complaint	[kəmˈpleɪnt] n. 抱怨；投诉；控告；（尤指不严重、常影响身体某部位的）疾病
grieve	[griːv] v. （使）伤心
fatigue	|
charity	[ˈtʃærətɪ] n. 慈善；施舍；慈善机构
sacrifice	|
ultimate	|
probable	[ˈprɔbəbl] a. 很可能的，大概的
disillusion	[ˏdɪsɪˈluːʒn] vt. 使醒悟
depletion	[dɪ'pli:ʃn] n. 消减，消耗
harmony	[ˈhɑːmənɪ] n. 相符，一致；和谐，融洽；[音] 和声
procedure	[prəˈsiːdʒə(r)] n. 程序，手续；过程
mood	[muːd] n. 心情，情绪
belief	[bɪˈliːf] n. 信仰，信条；相信
lens	[lenz] n. 透镜；镜片；镜头
inclusive	[ɪnˈkluːsɪv] a. 包括一切费用在内的；所有数目（或首尾日期）包括在内的；包容广阔的
optic	|
shade	|
availability	[əˌveɪlə'bɪlətɪ] n. 可利用性，可得性；利用的可能性；可利用的人或物
clot	|
abandon	[əˈbændən] vt. 放弃，遗弃
currency	[ˈkʌrənsɪ] n. 货币；通用，流行
estuary	[ˈestʃuərɪ] n. （江河入海口的）河口，河口湾
grin	[grɪn] v./n. 咧嘴笑
decrease	|
fraction	[ˈfrækʃn] n. 小部分，片断
acquisition	[ˏækwɪˈzɪʃn] n. 取得；获得物
alienation	[ˌeɪlɪə'neɪʃn] n. 疏远；离间
favour	|
centigrade	[ˈsentɪgreɪd] a. 百分度的；摄氏度的
ash	[æʃ] n. 灰；灰烬； [pl.] 骨灰，遗骸
sphere	[sfɪə(r)] n. 球（体）；范围，领域
bankrupt	[ˈbæŋkrʌpt] a. 破产的
snobbish	[ˈsnɒbɪʃ] a. 势利的，谄上欺下的；自命不凡的
defence	[dɪˈfens] n. 防御，保护；辩护；答辩； [pl.] 防务工事
comparison	[kəmˈpærɪsn] n. 比较，对比，对照；比喻，比拟
generative	[ˈdʒenərətɪv] a. 生殖的，生产的；有生产能力的
repatriate	[riːˈpætrɪeɪt] v. 把（某人）遣返回国；归国
abstraction	[æbˈstrækʃn] n. 抽象
stack	|
chew	[tʃuː] v. 咀嚼；回味；熟思
chart	|
teem	[tiːm] vi. 倾泻；充满，遍布
descend	[dɪˈsend] v. 下来，下降；遗传
albeit	[ˏɔːlˈbiːɪt] conj. 虽然，尽管
kidney	[ˈkɪdnɪ] n. 肾，肾脏
brief	|
goodwill	[ˏgudˈwɪl] n. 友好，善意；信誉
bizarre	[bɪˈzɑː(r)] a. 奇形怪状的；怪诞的
oak	[əuk] n. 橡树，橡木
in-addition-to	in addition to 除……之外
superior	|
intelligence	[ɪnˈtelɪdʒəns] n. 智力，理解力；情报
disorder	[dɪsˈɔːdə(r)] n. 混乱；失调，紊乱，疾病
shave	[ʃeɪv] n./v. 修面
campus	[ˈkæmpəs] n. 校园
capture	|
authentic	[ɔːˈθentɪk] a. 真品的，真迹的；真正的，真实的，逼真的
sympathy	__simpathy__ [ˈsɪmpəθɪ] n. 同情；赞同，支持
viscous	[ˈvɪskəs] a. 黏滞的，黏性的
disapprove	[ˏdɪsəˈpruːv] v. 不赞成，反对
trend	|
hall	[hɔːl] n. 门厅；礼堂
brunt	[brʌnt] n. 冲击；冲力
opposite	|
hasty	[ˈheɪstɪ] a. 草率的，匆忙的
elite	|
direction	[dɪˈrekʃn, daɪ-] n. 方向；趋势，动向； [pl.] 用法说明；指导
convenient	[kənˈviːnɪənt] a. 方便的，便利的；适宜的
emphasis	[ˈemfəsɪs] n. 强调；重要性
temporary	[ˈtemprərɪ] a. 临时的，暂时的
assume	[əˈsjuːm] vt. 假定，设想；承担（责任），就（职）
marsh	[mɑːʃ] n. 沼泽；湿地
venomous	[ˈvenəməs] a. 有毒的；分泌毒液的；恶意的，狠毒的
representative	|
fare	|
brood	|
rent	|
glossary	[ˈglɔsərɪ] n. 词汇表；术语表
therefore	[ˈðeəfɔː(r)] ad. 因此，所以
introduction	[ˏɪntrəˈdʌkʃn] n. 介绍；传入，引进；导言，绪论
mingle	[ˈmɪŋgl] v. （使）混合，（使）联结；相往来；混杂其中
erroneous	[ɪˈrəunɪəs] a. 错误的，不正确的
handy	[ˈhændɪ] a. 方便的；手边的；手巧的
rotate	[rəuˈteɪt] v. （使）旋转，转动；轮流，轮换
tortoise	[ˈtɔːtəs] n. 龟，陆龟；行动迟缓的人
origin	[ˈɔrɪdʒɪn] n. 起源；[常pl.] 出身
encounter	[ɪnˈkauntə(r)] vt./n. 遭遇，遇到
sentient	[ˈsenʃnt];[ˈsentiənt] a. 有感觉能力的，有知觉力的；知悉的
brutal	[ˈbruːtl] a. 野兽般的，残忍的；无情的，冷酷的
ornament	|
overwhelm	[ˏəuvəˈwelm] vt. 征服；淹没
bereave	[bɪˈriːv] vt. 使丧失，剥夺
alight	|
beforehand	[bɪˈfɔːhænd] ad. 预先，事先
unanimous	[juːˈnænɪməs] a. 一致同意的；一致通过的
linen	[ˈlɪnɪn] n. 亚麻织品；亚麻布
studious	[ˈstjuːdɪəs] a. 好学的，学习勤勉的；专心的；谨慎的，认真的，仔细的
crossword	[ˈkrɔswɜːd] n. 纵横填字游戏
forecast	[ˈfɔːkɑːst] n./vt. 预报；预测；预想
exploit	|
sanitary	|
vital	[ˈvaɪtl] a. 生死攸关的；极其重要的；有生命力的
ornamental	[ˌɔ:nəˈmentl] a. 装饰性的，装饰的
episodic	[ˌepɪˈsɒdɪk] a. 偶然发生的，不定期的；由许多片段组成的，松散的
veterinary	[ˈvetrɪnrɪ] a. 兽医的
sausage	[ˈsɔsɪdʒ] n. 香肠
diverse	[daɪˈvɜːs] a. 不同的，多样的
foetus	[ˈfiːtəs] n. 胎儿；胚胎
thorny	['θɔ:nɪ] a. 多刺的；痛苦的，棘手的
hazard	|
finite	[ˈfaɪnaɪt] a. 有限的；限定的
impressive	[ɪmˈpresɪv] a. 给人深刻印象的，令人敬佩的
smell	[smel] v. 散发（或有）……的气味；闻到，嗅到
scrupulous	[ˈskruːpjuləs] a. 多顾虑的，谨慎的（尤指道德方面）；一丝不苟的，严谨的
duration	[djuˈreɪʃn] n. 持续，持续的时间，期间
compulsory	[kəmˈpʌlsərɪ] a. 义务的；必须做的；强制性的；（课程）必修的
balance	|
donate	[dəuˈneɪt] vt. 捐赠，赠送
plagiarise	[ˈpleɪdʒəraɪz] v. 剽窃，抄袭
intensive	[ɪnˈtensɪv] a. 加强的；密集的
despoil	__dispoil__ [dɪˈspɔɪl] vt. 抢夺，掠夺；蹂躏，破坏
stream	[striːm] n. 溪流；一股  v. 流出
entitle	[ɪnˈtaɪtl] vt. 给……权利（或资格）；给（书、文章等）题名；给……以称号
stuff	|
urban	[ˈɜːbən] a. 都市的；住在都市的
honour	|
shatter	[ˈʃætə(r)] v. （使）破碎，碎裂；给予极大打击
scream	|
summary	[ˈsʌmərɪ] n. 摘要，概要  a. 概括的，简略的
bump	|
menace	|
bring-around	bring around  说服；使恢复知觉（或健康）
holistic	[həʊˈlɪstɪk] a. 整体的，全面的；功能整体性的
nocturnal	[nɔkˈtɜːnl] a. 夜晚的；夜晚发生的；夜晚活动的
calf	[kɑːf] n. 牛犊；崽，幼兽
diameter	__diamiter__ [daɪˈæmɪtə(r)] n. 直径
debris	[ˈdeɪbriː] n. 碎屑，残骸；[地质] 岩屑
purpose	|
commute	|
captivity	[kæpˈtɪvəti] n. 囚禁，拘留
contain	[kənˈteɪn] vt. 包含，容纳，装有；控制，阻止，遏制
crusade	|
attack	__attact__ [əˈtæk] n./v. 进攻；抨击；（疾病等）突然发作
audacious	[ɔːˈdeɪʃəs] a. 大胆的；有冒险精神的；鲁莽的；厚颜无耻的
guinea	[ˈgɪnɪ] n. 几尼（英国的旧货币单位，现值1.05镑）
technical	[ˈteknɪkl] a. 技术的，工艺的
prevalent	[ˈprevələnt] a. 流行的，普遍的
lime	[laɪm] n. 石灰
coordinate	|
cork	|
administer	[ədˈmɪnɪstə(r)] v. 掌管；给予
score	|
unwrap	[ʌnˈræp] vt. 打开，解开；除去包装
bulletin	[ˈbulətɪn] n. （报纸、电台等的）新闻简报；公告；学报；期刊（尤指机关刊物）
kneel	[niːl] vi. 跪
proposal	[prəˈpəuzl] n. 提议，建议；求婚
appropriate	|
iris	[ˈaɪərɪs] n. （pl. irises或irides）虹；（眼球的）虹膜
accurate	[ˈækjərət] a. 正确无误的；精确的
longitudinal	[lɔndʒiˈtju:dinl] a. 经度的，经线的；纵的；长度的
sanction	|
awful	[ˈɔːfl] a. 糟糕的
chorus	|
wheelchair	[ˈwi:ltʃeə(r)] n. （病人等用的）轮椅
miscellaneous	[ˏmɪsəˈleɪnɪəs] a. 各种各样的；混杂的
except	|
assure	[əˈʃʊə(r)] vt. 使确信，使确保；保证，向……保证
celebrity	[sɪˈlebrətɪ] n. 名声；知名人士
bunch	|
genuine	[ˈdʒenjuɪn] a. 真正的；真实的
thirsty	['θɜ:stɪ] a. 口渴的；饥渴的
intelligible	[ɪnˈtelɪdʒəbl] a. 可理解的，明白易懂的，清楚的
embankment	__embarkment__ [ɪmˈbæŋkmənt] n. 筑堤；堤岸，路基
reserve	|
accelerate	[əkˈseləreɪt] v. 加速；促进
